Accession,Year,Location,Plot,Block,Row,Column,R1 (DAP),R8 (DAP),RL (DAP)
PI153243,2017,Columbia-MO,A1,1,1,1,52,120,68
PI253661B,2017,Columbia-MO,A10,1,1,10,55,118,63
PI283331,2017,Columbia-MO,A11,1,1,11,54,128,74
PI370055,2017,Columbia-MO,A12,1,1,12,48,121,73
PI371611,2017,Columbia-MO,A13,1,1,13,47,130,83
PI398881,2017,Columbia-MO,A14,1,1,14,47,127,80
PI404173B,2017,Columbia-MO,A15,1,1,15,55,132,77
PI547477,2017,Columbia-MO,A154,1,5,10,53,128,75
PI417526,2017,Columbia-MO,A16,1,1,16,49,128,79
PI547484,2017,Columbia-MO,A161,1,5,17,48,127,79
PI417573,2017,Columbia-MO,A17,1,1,17,52,123,71
PI547500,2017,Columbia-MO,A173,1,5,29,59,128,69
PI424159B,2017,Columbia-MO,A18,1,1,18,49,129,80
PI424405A,2017,Columbia-MO,A19,1,1,19,52,128,76
PI153292,2017,Columbia-MO,A2,1,1,2,40,121,81
PI424405B,2017,Columbia-MO,A20,1,1,20,56,133,77
PI547545,2017,Columbia-MO,A202,1,6,22,54,130,76
PI432359,2017,Columbia-MO,A22,1,1,22,50,130,80
PI437103,2017,Columbia-MO,A23,1,1,23,52,122,70
PI547598,2017,Columbia-MO,A235,1,7,19,45,127,82
PI437124,2017,Columbia-MO,A24,1,1,24,49,121,72
PI547617,2017,Columbia-MO,A244,1,7,28,47,126,79
PI437338,2017,Columbia-MO,A26,1,1,26,58,129,71
PI547655,2017,Columbia-MO,A268,1,8,16,50,127,77
PI437357,2017,Columbia-MO,A27,1,1,27,48,115,67
PI547657,2017,Columbia-MO,A270,1,8,18,49,124,75
PI547663,2017,Columbia-MO,A273,1,8,21,55,125,70
PI547798,2017,Columbia-MO,A284,1,8,32,44,126,82
PI547800,2017,Columbia-MO,A285,1,8,33,51,124,73
PI547801,2017,Columbia-MO,A286,1,8,34,51,127,76
PI547802,2017,Columbia-MO,A287,1,8,35,49,125,76
PI547811,2017,Columbia-MO,A288,1,8,36,45,125,80
PI547813,2017,Columbia-MO,A289,1,9,1,48,125,77
PI547814,2017,Columbia-MO,A290,1,9,2,52,126,74
PI170380,2017,Columbia-MO,A3,1,1,3,48,121,73
PI547847,2017,Columbia-MO,A305,1,9,17,49,125,76
PI437377,2017,Columbia-MO,A31,1,1,31,51,129,78
PI547860,2017,Columbia-MO,A318,1,9,30,45,126,81
PI437388,2017,Columbia-MO,A32,1,1,32,53,121,68
PI547864,2017,Columbia-MO,A321,1,9,33,44,124,80
PI547869,2017,Columbia-MO,A326,1,10,2,50,126,76
PI437391,2017,Columbia-MO,A33,1,1,33,50,131,81
PI547876,2017,Columbia-MO,A332,1,10,8,50,125,75
PI547879,2017,Columbia-MO,A334,1,10,10,52,128,76
PI547885,2017,Columbia-MO,A338,1,10,14,48,125,77
PI437392,2017,Columbia-MO,A34,1,1,34,51,129,78
PI548174,2017,Columbia-MO,A346,1,10,22,50,127,77
PI548180,2017,Columbia-MO,A348,1,10,24,49,124,75
PI437397,2017,Columbia-MO,A35,1,1,35,54,133,79
PI548192,2017,Columbia-MO,A350,1,10,26,54,130,76
PI548193,2017,Columbia-MO,A351,1,10,27,48,127,79
PI548194,2017,Columbia-MO,A352,1,10,28,49,127,78
PI548204,2017,Columbia-MO,A354,1,10,30,55,124,69
PI548222,2017,Columbia-MO,A355,1,10,31,53,125,72
PI548231,2017,Columbia-MO,A356,1,10,32,51,132,81
PI548242,2017,Columbia-MO,A357,1,10,33,46,125,79
PI548247,2017,Columbia-MO,A358,1,10,34,49,128,79
PI548250,2017,Columbia-MO,A359,1,10,35,56,131,75
PI437412,2017,Columbia-MO,A36,1,1,36,45,121,76
PI548253,2017,Columbia-MO,A360,1,10,36,53,132,79
PI548260,2017,Columbia-MO,A361,1,11,1,58,127,69
PI548262,2017,Columbia-MO,A362,1,11,2,44,126,82
PI548267,2017,Columbia-MO,A363,1,11,3,55,127,72
PI548275,2017,Columbia-MO,A364,1,11,4,47,126,79
PI548297,2017,Columbia-MO,A366,1,11,6,54,131,77
PI548304,2017,Columbia-MO,A367,1,11,7,42,126,84
PI437422,2017,Columbia-MO,A37,1,2,1,47,127,80
PI548365,2017,Columbia-MO,A371,1,11,11,45,119,74
PI548366,2017,Columbia-MO,A372,1,11,12,48,119,71
PI548373,2017,Columbia-MO,A374,1,11,14,52,118,66
PI548381,2017,Columbia-MO,A375,1,11,15,42,126,84
PI548383,2017,Columbia-MO,A376,1,11,16,53,126,73
PI548400,2017,Columbia-MO,A377,1,11,17,51,128,77
PI548410,2017,Columbia-MO,A378,1,11,18,51,122,71
PI548412,2017,Columbia-MO,A379,1,11,19,44,123,79
PI437444,2017,Columbia-MO,A38,1,2,2,50,127,77
PI548421,2017,Columbia-MO,A380,1,11,20,43,125,82
PI548517,2017,Columbia-MO,A381,1,11,21,49,125,76
PI548522,2017,Columbia-MO,A382,1,11,22,48,126,78
PI548525,2017,Columbia-MO,A383,1,11,23,52,126,74
PI548532,2017,Columbia-MO,A384,1,11,24,50,130,80
PI548541,2017,Columbia-MO,A386,1,11,26,53,132,79
PI548542,2017,Columbia-MO,A387,1,11,27,41,125,84
PI548543,2017,Columbia-MO,A388,1,11,28,43,125,82
PI548546,2017,Columbia-MO,A389,1,11,29,50,124,74
PI437459,2017,Columbia-MO,A39,1,2,3,58,124,66
PI548547,2017,Columbia-MO,A390,1,11,30,52,128,76
PI548549,2017,Columbia-MO,A391,1,11,31,55,128,73
PI548555,2017,Columbia-MO,A392,1,11,32,47,133,86
PI548558,2017,Columbia-MO,A393,1,11,33,45,125,80
PI548559,2017,Columbia-MO,A394,1,11,34,50,133,83
PI548562,2017,Columbia-MO,A395,1,11,35,47,123,76
PI548585,2017,Columbia-MO,A396,1,11,36,51,127,76
PI548597,2017,Columbia-MO,A397,1,12,1,45,123,78
PI548598,2017,Columbia-MO,A398,1,12,2,52,127,75
PI548602,2017,Columbia-MO,A399,1,12,3,55,132,77
PI189926,2017,Columbia-MO,A4,1,1,4,49,129,80
PI437461,2017,Columbia-MO,A40,1,2,4,53,128,75
PI548603,2017,Columbia-MO,A400,1,12,4,52,127,75
PI548613,2017,Columbia-MO,A401,1,12,5,55,132,77
PI548632,2017,Columbia-MO,A403,1,12,7,43,122,79
PI548633,2017,Columbia-MO,A404,1,12,8,53,130,77
PI548635,2017,Columbia-MO,A405,1,12,9,51,126,75
PI548636,2017,Columbia-MO,A406,1,12,10,50,127,77
PI548652,2017,Columbia-MO,A407,1,12,11,48,128,80
PI548671,2017,Columbia-MO,A409,1,12,13,54,129,75
PI437463B,2017,Columbia-MO,A41,1,2,5,43,121,78
PI548678,2017,Columbia-MO,A410,1,12,14,58,132,74
PI548679,2017,Columbia-MO,A411,1,12,15,52,131,79
PI548682,2017,Columbia-MO,A412,1,12,16,51,130,79
PI548684,2017,Columbia-MO,A413,1,12,17,49,128,79
PI548685,2017,Columbia-MO,A414,1,12,18,50,129,79
PI548686,2017,Columbia-MO,A415,1,12,19,44,124,80
PI552538,2017,Columbia-MO,A416,1,12,20,46,124,78
PI555396,2017,Columbia-MO,A417,1,12,21,48,131,83
PI555399,2017,Columbia-MO,A418,1,12,22,55,134,79
PI556511,2017,Columbia-MO,A419,1,12,23,40,125,85
PI437464,2017,Columbia-MO,A42,1,2,6,47,126,79
PI556572,2017,Columbia-MO,A420,1,12,24,50,126,76
PI556687,2017,Columbia-MO,A421,1,12,25,52,130,78
PI556778,2017,Columbia-MO,A422,1,12,26,40,125,85
PI556780,2017,Columbia-MO,A423,1,12,27,45,127,82
PI556781,2017,Columbia-MO,A424,1,12,28,40,128,88
PI556814,2017,Columbia-MO,A425,1,12,29,47,132,85
PI556816,2017,Columbia-MO,A426,1,12,30,51,126,75
PI556857,2017,Columbia-MO,A427,1,12,31,44,129,85
PI556859,2017,Columbia-MO,A428,1,12,32,49,125,76
PI556889,2017,Columbia-MO,A429,1,12,33,50,131,81
PI437467,2017,Columbia-MO,A43,1,2,7,55,126,71
PI556928,2017,Columbia-MO,A430,1,12,34,45,128,83
PI556931,2017,Columbia-MO,A431,1,12,35,41,125,84
PI556932,2017,Columbia-MO,A432,1,12,36,55,132,77
PI556989,2017,Columbia-MO,A433,1,13,1,47,126,79
PI559931,2017,Columbia-MO,A434,1,13,2,50,127,77
PI560207,2017,Columbia-MO,A436,1,13,4,55,130,75
PI564718,2017,Columbia-MO,A439,1,13,7,50,124,74
PI437487,2017,Columbia-MO,A44,1,2,8,52,129,77
PI567250B,2017,Columbia-MO,A440,1,13,8,53,132,79
PI567351B,2017,Columbia-MO,A441,1,13,9,51,132,81
PI567366A,2017,Columbia-MO,A442,1,13,10,56,127,71
PI567404A,2017,Columbia-MO,A443,1,13,11,55,124,69
PI567527,2017,Columbia-MO,A444,1,13,12,53,130,77
PI567767B,2017,Columbia-MO,A445,1,13,13,48,125,77
PI568245,2017,Columbia-MO,A446,1,13,14,50,125,75
PI574532,2017,Columbia-MO,A447,1,13,15,46,123,77
PI574534,2017,Columbia-MO,A448,1,13,16,43,124,81
PI574541,2017,Columbia-MO,A449,1,13,17,50,127,77
PI437500B,2017,Columbia-MO,A45,1,2,9,47,124,77
PI576160,2017,Columbia-MO,A450,1,13,18,46,124,78
PI576166,2017,Columbia-MO,A451,1,13,19,49,128,79
PI577798,2017,Columbia-MO,A452,1,13,20,53,131,78
PI578057,2017,Columbia-MO,A453,1,13,21,50,123,73
PI584441,2017,Columbia-MO,A454,1,13,22,50,125,75
PI584470,2017,Columbia-MO,A455,1,13,23,46,124,78
PI586980,2017,Columbia-MO,A456,1,13,24,45,124,79
PI590932,2017,Columbia-MO,A457,1,13,25,51,131,80
PI591490,2017,Columbia-MO,A458,1,13,26,51,133,82
PI591492,2017,Columbia-MO,A459,1,13,27,45,130,85
PI437500C,2017,Columbia-MO,A46,1,2,10,53,126,73
PI591493,2017,Columbia-MO,A460,1,13,28,55,129,74
PI591494,2017,Columbia-MO,A461,1,13,29,53,130,77
PI591495,2017,Columbia-MO,A462,1,13,30,53,131,78
PI591497,2017,Columbia-MO,A463,1,13,31,47,127,80
PI591498,2017,Columbia-MO,A464,1,13,32,46,126,80
PI591499,2017,Columbia-MO,A465,1,13,33,51,128,77
PI591503,2017,Columbia-MO,A466,1,13,34,49,126,77
PI591504,2017,Columbia-MO,A467,1,13,35,49,127,78
PI591505,2017,Columbia-MO,A468,1,13,36,50,127,77
PI591506,2017,Columbia-MO,A469,1,14,1,40,125,85
PI437550C,2017,Columbia-MO,A47,1,2,11,49,121,72
PI591507,2017,Columbia-MO,A470,1,14,2,46,126,80
PI591509,2017,Columbia-MO,A471,1,14,3,46,126,80
PI591510,2017,Columbia-MO,A472,1,14,4,50,125,75
PI591512,2017,Columbia-MO,A473,1,14,5,46,125,79
PI591515,2017,Columbia-MO,A475,1,14,7,44,122,78
PI591516,2017,Columbia-MO,A476,1,14,8,48,126,78
PI591517,2017,Columbia-MO,A477,1,14,9,50,126,76
PI591518,2017,Columbia-MO,A478,1,14,10,48,126,78
PI591519,2017,Columbia-MO,A479,1,14,11,46,126,80
PI591521,2017,Columbia-MO,A480,1,14,12,49,126,77
PI591526,2017,Columbia-MO,A481,1,14,13,51,126,75
PI591528,2017,Columbia-MO,A482,1,14,14,50,126,76
PI591530,2017,Columbia-MO,A483,1,14,15,49,127,78
PI591533,2017,Columbia-MO,A486,1,14,18,50,127,77
PI591534,2017,Columbia-MO,A487,1,14,19,42,124,82
PI591535,2017,Columbia-MO,A488,1,14,20,48,127,79
PI591536,2017,Columbia-MO,A489,1,14,21,51,129,78
PI437711B,2017,Columbia-MO,A49,1,2,13,52,133,81
PI591537,2017,Columbia-MO,A490,1,14,22,49,130,81
PI591538,2017,Columbia-MO,A491,1,14,23,44,126,82
PI591539,2017,Columbia-MO,A492,1,14,24,49,126,77
PI591540,2017,Columbia-MO,A493,1,14,25,52,126,74
PI591561,2017,Columbia-MO,A494,1,14,26,49,126,77
PI592946,2017,Columbia-MO,A495,1,14,27,50,127,77
PI593256,2017,Columbia-MO,A496,1,14,28,50,127,77
PI593258,2017,Columbia-MO,A497,1,14,29,45,127,82
PI593463,2017,Columbia-MO,A498,1,14,30,50,127,77
PI593654,2017,Columbia-MO,A499,1,14,31,51,127,76
PI189928,2017,Columbia-MO,A5,1,1,5,47,120,73
PI437788B,2017,Columbia-MO,A50,1,2,14,54,133,79
PI595363,2017,Columbia-MO,A500,1,14,32,53,130,77
PI595754,2017,Columbia-MO,A501,1,14,33,50,125,75
PI595926,2017,Columbia-MO,A502,1,14,34,50,122,72
PI596407,2017,Columbia-MO,A503,1,14,35,51,126,75
PI597382,2017,Columbia-MO,A504,1,14,36,42,128,86
PI597387,2017,Columbia-MO,A505,1,15,1,41,126,85
PI602449,2017,Columbia-MO,A506,1,15,2,52,126,74
PI602450,2017,Columbia-MO,A507,1,15,3,57,127,70
PI603186,2017,Columbia-MO,A508,1,15,4,52,126,74
PI603188,2017,Columbia-MO,A509,1,15,5,47,127,80
PI437789,2017,Columbia-MO,A51,1,2,15,55,133,78
PI603193,2017,Columbia-MO,A510,1,15,6,51,130,79
PI603201,2017,Columbia-MO,A511,1,15,7,58,132,74
PI603205,2017,Columbia-MO,A512,1,15,8,50,128,78
PI603396,2017,Columbia-MO,A513,1,15,9,55,128,73
PI603428D,2017,Columbia-MO,A514,1,15,10,49,130,81
PI603434,2017,Columbia-MO,A515,1,15,11,43,123,80
PI603454,2017,Columbia-MO,A517,1,15,13,50,126,76
PI603564A,2017,Columbia-MO,A518,1,15,14,55,128,73
PI603564B,2017,Columbia-MO,A519,1,15,15,50,133,83
PI437790,2017,Columbia-MO,A52,1,2,16,53,131,78
PI603564C,2017,Columbia-MO,A520,1,15,16,47,134,87
PI603571B,2017,Columbia-MO,A521,1,15,17,46,129,83
PI603915D,2017,Columbia-MO,A522,1,15,18,47,127,80
PI606748,2017,Columbia-MO,A523,1,15,19,45,130,85
PI606749,2017,Columbia-MO,A524,1,15,20,45,130,85
PI610670,2017,Columbia-MO,A525,1,15,21,49,127,78
PI612594,2017,Columbia-MO,A526,1,15,22,45,127,82
PI612750,2017,Columbia-MO,A527,1,15,23,48,124,76
PI612932,2017,Columbia-MO,A528,1,15,24,48,123,75
PI614153,2017,Columbia-MO,A529,1,15,25,46,127,81
PI437877C,2017,Columbia-MO,A53,1,2,17,43,128,85
PI614154,2017,Columbia-MO,A530,1,15,26,43,126,83
PI614832,2017,Columbia-MO,A532,1,15,28,49,128,79
PI615555,2017,Columbia-MO,A533,1,15,29,49,124,75
PI633729,2017,Columbia-MO,A535,1,15,31,50,127,77
PI633732,2017,Columbia-MO,A536,1,15,32,50,128,78
PI634761,2017,Columbia-MO,A537,1,15,33,50,122,72
PI634762,2017,Columbia-MO,A538,1,15,34,55,127,72
PI634763,2017,Columbia-MO,A539,1,15,35,51,132,81
PI437888B,2017,Columbia-MO,A54,1,2,18,51,121,70
PI634764,2017,Columbia-MO,A540,1,15,36,54,128,74
PI634765,2017,Columbia-MO,A541,1,16,1,49,124,75
PI636464,2017,Columbia-MO,A542,1,16,2,51,125,74
PI636695,2017,Columbia-MO,A543,1,16,3,45,131,86
PI548574,2017,Columbia-MO,A548,1,16,8,51,122,71
PI548622,2017,Columbia-MO,A549,1,16,9,45,125,80
PI437894,2017,Columbia-MO,A55,1,2,19,50,126,76
PI548634,2017,Columbia-MO,A552,1,16,12,50,124,74
PI598124,2017,Columbia-MO,A553,1,16,13,39,127,88
PI639740,2017,Columbia-MO,A554,1,16,14,52,131,79
PI643146,2017,Columbia-MO,A555,1,16,15,48,128,80
PI518671,2017,Columbia-MO,A556,1,16,16,51,130,79
PI438073,2017,Columbia-MO,A57,1,2,21,54,133,79
PI438079,2017,Columbia-MO,A58,1,2,22,53,127,74
PI438124B,2017,Columbia-MO,A59,1,2,23,50,130,80
PI189935,2017,Columbia-MO,A6,1,1,6,49,125,76
PI438252C,2017,Columbia-MO,A60,1,2,24,48,132,84
PI438303,2017,Columbia-MO,A61,1,2,25,55,132,77
PI438310,2017,Columbia-MO,A62,1,2,26,51,129,78
PI438312,2017,Columbia-MO,A63,1,2,27,62,123,61
PI438341,2017,Columbia-MO,A64,1,2,28,42,115,73
PI438357B,2017,Columbia-MO,A65,1,2,29,50,128,78
PI438409,2017,Columbia-MO,A66,1,2,30,59,119,60
PI438486,2017,Columbia-MO,A67,1,2,31,54,126,72
PI438495,2017,Columbia-MO,A68,1,2,32,59,129,70
PI438500,2017,Columbia-MO,A69,1,2,33,59,125,66
PI209331,2017,Columbia-MO,A7,1,1,7,51,123,72
PI475822B,2017,Columbia-MO,A70,1,2,34,59,130,71
PI479740,2017,Columbia-MO,A72,1,2,36,48,120,72
PI507708,2017,Columbia-MO,A76,1,3,4,44,124,80
PI515961,2017,Columbia-MO,A77,1,3,5,50,132,82
PI518663,2017,Columbia-MO,A78,1,3,6,57,134,77
PI248402,2017,Columbia-MO,A8,1,1,8,56,130,74
PI518668,2017,Columbia-MO,A80,1,3,8,53,132,79
PI518671,2017,Columbia-MO,A81,1,3,9,51,130,79
PI518673,2017,Columbia-MO,A82,1,3,10,49,131,82
PI518675,2017,Columbia-MO,A83,1,3,11,48,120,72
PI525454,2017,Columbia-MO,A84,1,3,12,53,131,78
PI533654,2017,Columbia-MO,A85,1,3,13,51,131,80
PI534645,2017,Columbia-MO,A86,1,3,14,48,127,79
PI534646,2017,Columbia-MO,A87,1,3,15,53,129,76
PI534647,2017,Columbia-MO,A88,1,3,16,48,128,80
PI534648,2017,Columbia-MO,A89,1,3,17,45,129,84
PI253660A,2017,Columbia-MO,A9,1,1,9,50,126,76
PI540555,2017,Columbia-MO,A91,1,3,19,48,131,83
PI542043,2017,Columbia-MO,A92,1,3,20,51,130,79
PI542044,2017,Columbia-MO,A93,1,3,21,50,126,76
PI542709,2017,Columbia-MO,A94,1,3,22,48,126,78
PI542711,2017,Columbia-MO,A95,1,3,23,47,127,80
PI543793,2017,Columbia-MO,A96,1,3,24,49,132,83
PI248402,2018,Columbia-MO,B1,1,1,1,47,129,82
PI437391,2018,Columbia-MO,B10,1,1,10,36,127,91
PI518671,2018,Columbia-MO,B102,1,6,2,39,136,97
PI437459,2018,Columbia-MO,B11,1,1,11,37,126,89
PI547500,2018,Columbia-MO,B110,1,6,10,34,128,94
PI437500B,2018,Columbia-MO,B12,1,1,12,33,122,89
PI438124B,2018,Columbia-MO,B13,1,1,13,41,127,86
PI547545,2018,Columbia-MO,B136,1,7,16,39,130,91
PI518671,2018,Columbia-MO,B139,1,7,19,41,140,99
PI438310,2018,Columbia-MO,B14,1,1,14,40,121,81
PI438409,2018,Columbia-MO,B15,1,1,15,39,129,90
PI518671,2018,Columbia-MO,B154,1,8,14,38,134,96
PI518671,2018,Columbia-MO,B16,1,1,16,44,139,95
PI518671,2018,Columbia-MO,B164,1,9,4,41,132,91
PI547598,2018,Columbia-MO,B169,1,9,9,35,129,94
PI547617,2018,Columbia-MO,B177,1,9,17,36,126,90
PI438486,2018,Columbia-MO,B18,1,1,18,41,127,86
PI438500,2018,Columbia-MO,B19,1,1,19,42,123,81
PI518671,2018,Columbia-MO,B194,1,10,14,41,135,94
PI547655,2018,Columbia-MO,B199,1,10,19,41,133,92
PI253660A,2018,Columbia-MO,B2,1,1,2,47,132,85
PI475822B,2018,Columbia-MO,B20,1,1,20,46,128,82
PI547657,2018,Columbia-MO,B201,1,11,1,37,123,86
PI547663,2018,Columbia-MO,B203,1,11,3,36,124,88
PI479740,2018,Columbia-MO,B21,1,2,1,34,124,90
PI518671,2018,Columbia-MO,B212,1,11,12,40,134,94
PI547798,2018,Columbia-MO,B216,1,11,16,39,126,87
PI547800,2018,Columbia-MO,B217,1,11,17,41,124,83
PI547801,2018,Columbia-MO,B218,1,11,18,36,127,91
PI547802,2018,Columbia-MO,B219,1,11,19,40,129,89
PI507708,2018,Columbia-MO,B22,1,2,2,44,125,81
PI547811,2018,Columbia-MO,B220,1,11,20,37,136,99
PI547813,2018,Columbia-MO,B221,1,12,1,36,119,83
PI547814,2018,Columbia-MO,B222,1,12,2,36,119,83
PI518671,2018,Columbia-MO,B225,1,12,5,41,133,92
PI515961,2018,Columbia-MO,B23,1,2,3,40,140,100
PI547847,2018,Columbia-MO,B239,1,12,19,45,136,91
PI518673,2018,Columbia-MO,B24,1,2,4,36,132,96
PI518671,2018,Columbia-MO,B242,1,13,2,39,128,89
PI518675,2018,Columbia-MO,B25,1,2,5,32,126,94
PI547860,2018,Columbia-MO,B254,1,13,14,35,130,95
PI547864,2018,Columbia-MO,B257,1,13,17,36,123,87
PI525454,2018,Columbia-MO,B26,1,2,6,41,137,96
PI547869,2018,Columbia-MO,B261,1,14,1,36,126,90
PI547876,2018,Columbia-MO,B267,1,14,7,37,124,87
PI518671,2018,Columbia-MO,B268,1,14,8,41,130,89
PI533654,2018,Columbia-MO,B27,1,2,7,38,128,90
PI547879,2018,Columbia-MO,B271,1,14,11,36,122,86
PI547885,2018,Columbia-MO,B275,1,14,15,39,129,90
PI534645,2018,Columbia-MO,B28,1,2,8,33,127,94
PI548193,2018,Columbia-MO,B283,1,15,3,41,126,85
PI548194,2018,Columbia-MO,B284,1,15,4,38,126,88
PI548198,2018,Columbia-MO,B285,1,15,5,49,122,73
PI548204,2018,Columbia-MO,B286,1,15,6,40,116,76
PI518671,2018,Columbia-MO,B287,1,15,7,40,130,90
PI548222,2018,Columbia-MO,B289,1,15,9,38,121,83
PI534646,2018,Columbia-MO,B29,1,2,9,36,128,92
PI548231,2018,Columbia-MO,B290,1,15,10,38,127,89
PI548242,2018,Columbia-MO,B291,1,15,11,34,124,90
PI548253,2018,Columbia-MO,B292,1,15,12,36,127,91
PI548260,2018,Columbia-MO,B293,1,15,13,48,132,84
PI548262,2018,Columbia-MO,B294,1,15,14,35,128,93
PI548267,2018,Columbia-MO,B295,1,15,15,42,134,92
PI548275,2018,Columbia-MO,B296,1,15,16,41,129,88
PI548286,2018,Columbia-MO,B297,1,15,17,34,127,93
PI548410,2018,Columbia-MO,B298,1,15,18,44,126,82
PI548517,2018,Columbia-MO,B299,1,15,19,38,130,92
PI283331,2018,Columbia-MO,B3,1,1,3,47,132,85
PI534647,2018,Columbia-MO,B30,1,2,10,31,127,96
PI548522,2018,Columbia-MO,B300,1,15,20,38,133,95
PI548525,2018,Columbia-MO,B301,1,16,1,42,118,76
PI548532,2018,Columbia-MO,B302,1,16,2,37,124,87
PI518671,2018,Columbia-MO,B304,1,16,4,39,128,89
PI548541,2018,Columbia-MO,B306,1,16,6,45,133,88
PI548542,2018,Columbia-MO,B307,1,16,7,35,122,87
PI548543,2018,Columbia-MO,B308,1,16,8,35,126,91
PI548546,2018,Columbia-MO,B309,1,16,9,40,122,82
PI518671,2018,Columbia-MO,B31,1,2,11,43,140,97
PI548547,2018,Columbia-MO,B310,1,16,10,36,122,86
PI548549,2018,Columbia-MO,B311,1,16,11,35,127,92
PI548555,2018,Columbia-MO,B312,1,16,12,38,137,99
PI548558,2018,Columbia-MO,B313,1,16,13,37,127,90
PI548585,2018,Columbia-MO,B314,1,16,14,34,127,93
PI548597,2018,Columbia-MO,B315,1,16,15,37,127,90
PI548598,2018,Columbia-MO,B316,1,16,16,36,133,97
PI548602,2018,Columbia-MO,B317,1,16,17,37,130,93
PI548603,2018,Columbia-MO,B318,1,16,18,47,130,83
PI548613,2018,Columbia-MO,B319,1,16,19,45,140,95
PI548632,2018,Columbia-MO,B320,1,16,20,37,129,92
PI548633,2018,Columbia-MO,B321,1,17,1,41,122,81
PI548635,2018,Columbia-MO,B322,1,17,2,38,119,81
PI548636,2018,Columbia-MO,B323,1,17,3,38,125,87
PI518671,2018,Columbia-MO,B324,1,17,4,41,127,86
PI548652,2018,Columbia-MO,B326,1,17,6,34,123,89
PI548678,2018,Columbia-MO,B327,1,17,7,51,138,87
PI548679,2018,Columbia-MO,B328,1,17,8,40,138,98
PI548682,2018,Columbia-MO,B329,1,17,9,35,126,91
PI534648,2018,Columbia-MO,B33,1,2,13,38,133,95
PI548685,2018,Columbia-MO,B330,1,17,10,39,128,89
PI555396,2018,Columbia-MO,B332,1,17,12,36,129,93
PI555399,2018,Columbia-MO,B333,1,17,13,48,142,94
PI556511,2018,Columbia-MO,B334,1,17,14,31,129,98
PI556572,2018,Columbia-MO,B335,1,17,15,38,134,96
PI556687,2018,Columbia-MO,B336,1,17,16,42,135,93
PI556778,2018,Columbia-MO,B337,1,17,17,34,127,93
PI556780,2018,Columbia-MO,B338,1,17,18,34,130,96
PI556781,2018,Columbia-MO,B339,1,17,19,36,130,94
PI540555,2018,Columbia-MO,B34,1,2,14,36,137,101
PI556814,2018,Columbia-MO,B340,1,17,20,33,136,103
PI556816,2018,Columbia-MO,B341,1,18,1,36,124,88
PI556857,2018,Columbia-MO,B342,1,18,2,34,127,93
PI556859,2018,Columbia-MO,B343,1,18,3,34,125,91
PI556889,2018,Columbia-MO,B344,1,18,4,38,129,91
PI556928,2018,Columbia-MO,B345,1,18,5,41,123,82
PI556931,2018,Columbia-MO,B346,1,18,6,31,120,89
PI556932,2018,Columbia-MO,B347,1,18,7,39,134,95
PI518671,2018,Columbia-MO,B348,1,18,8,39,133,94
PI542043,2018,Columbia-MO,B35,1,2,15,38,130,92
PI556989,2018,Columbia-MO,B350,1,18,10,35,123,88
PI559931,2018,Columbia-MO,B351,1,18,11,33,124,91
PI560207,2018,Columbia-MO,B352,1,18,12,42,138,96
PI564718,2018,Columbia-MO,B353,1,18,13,41,129,88
PI567767B,2018,Columbia-MO,B354,1,18,14,38,126,88
PI568245,2018,Columbia-MO,B355,1,18,15,36,133,97
PI574532,2018,Columbia-MO,B356,1,18,16,35,126,91
PI574534,2018,Columbia-MO,B357,1,18,17,33,125,92
PI576160,2018,Columbia-MO,B358,1,18,18,35,130,95
PI576166,2018,Columbia-MO,B359,1,18,19,37,137,100
PI542044,2018,Columbia-MO,B36,1,2,16,38,129,91
PI578057,2018,Columbia-MO,B360,1,18,20,41,133,92
PI584441,2018,Columbia-MO,B361,1,19,1,37,122,85
PI518671,2018,Columbia-MO,B362,1,19,2,36,123,87
PI584470,2018,Columbia-MO,B364,1,19,4,35,120,85
PI586980,2018,Columbia-MO,B365,1,19,5,33,121,88
PI590932,2018,Columbia-MO,B366,1,19,6,37,130,93
PI591490,2018,Columbia-MO,B367,1,19,7,32,120,88
PI591492,2018,Columbia-MO,B368,1,19,8,41,125,84
PI591493,2018,Columbia-MO,B369,1,19,9,38,121,83
PI542709,2018,Columbia-MO,B37,1,2,17,36,127,91
PI591494,2018,Columbia-MO,B370,1,19,10,37,124,87
PI591495,2018,Columbia-MO,B371,1,19,11,46,126,80
PI591497,2018,Columbia-MO,B372,1,19,12,35,125,90
PI591498,2018,Columbia-MO,B373,1,19,13,38,130,92
PI591499,2018,Columbia-MO,B374,1,19,14,37,126,89
PI591503,2018,Columbia-MO,B375,1,19,15,36,130,94
PI591504,2018,Columbia-MO,B376,1,19,16,36,119,83
PI591505,2018,Columbia-MO,B377,1,19,17,36,129,93
PI591506,2018,Columbia-MO,B378,1,19,18,36,130,94
PI591507,2018,Columbia-MO,B379,1,19,19,41,130,89
PI542711,2018,Columbia-MO,B38,1,2,18,34,136,102
PI591509,2018,Columbia-MO,B380,1,19,20,35,133,98
PI591510,2018,Columbia-MO,B381,1,20,1,36,125,89
PI591512,2018,Columbia-MO,B382,1,20,2,36,122,86
PI591515,2018,Columbia-MO,B383,1,20,3,36,123,87
PI591516,2018,Columbia-MO,B384,1,20,4,35,122,87
PI518671,2018,Columbia-MO,B385,1,20,5,40,126,86
PI591517,2018,Columbia-MO,B387,1,20,7,34,123,89
PI591518,2018,Columbia-MO,B388,1,20,8,36,125,89
PI591519,2018,Columbia-MO,B389,1,20,9,35,122,87
PI543793,2018,Columbia-MO,B39,1,2,19,38,140,102
PI591521,2018,Columbia-MO,B390,1,20,10,37,122,85
PI591526,2018,Columbia-MO,B391,1,20,11,36,124,88
PI591528,2018,Columbia-MO,B392,1,20,12,38,127,89
PI591530,2018,Columbia-MO,B393,1,20,13,40,129,89
PI591533,2018,Columbia-MO,B394,1,20,14,38,124,86
PI591534,2018,Columbia-MO,B395,1,20,15,38,125,87
PI591537,2018,Columbia-MO,B396,1,20,16,35,132,97
PI591538,2018,Columbia-MO,B397,1,20,17,34,127,93
PI591539,2018,Columbia-MO,B398,1,20,18,38,126,88
PI591540,2018,Columbia-MO,B399,1,20,19,37,128,91
PI371611,2018,Columbia-MO,B4,1,1,4,41,132,91
PI591561,2018,Columbia-MO,B400,1,20,20,33,138,105
PI592946,2018,Columbia-MO,B401,1,21,1,38,125,87
PI593256,2018,Columbia-MO,B402,1,21,2,37,126,89
PI518671,2018,Columbia-MO,B403,1,21,3,39,127,88
PI593258,2018,Columbia-MO,B405,1,21,5,33,125,92
PI593463,2018,Columbia-MO,B406,1,21,6,35,121,86
PI593654,2018,Columbia-MO,B407,1,21,7,37,129,92
PI595363,2018,Columbia-MO,B408,1,21,8,36,130,94
PI595754,2018,Columbia-MO,B409,1,21,9,35,123,88
PI595926,2018,Columbia-MO,B410,1,21,10,31,119,88
PI596407,2018,Columbia-MO,B411,1,21,11,36,124,88
PI597382,2018,Columbia-MO,B412,1,21,12,34,128,94
PI597387,2018,Columbia-MO,B413,1,21,13,38,130,92
PI602449,2018,Columbia-MO,B414,1,21,14,41,126,85
PI602450,2018,Columbia-MO,B415,1,21,15,45,129,84
PI603186,2018,Columbia-MO,B416,1,21,16,44,128,84
PI603188,2018,Columbia-MO,B417,1,21,17,41,130,89
PI603193,2018,Columbia-MO,B418,1,21,18,43,130,87
PI603454,2018,Columbia-MO,B419,1,21,19,42,132,90
PI603571B,2018,Columbia-MO,B420,1,21,20,36,134,98
PI603915D,2018,Columbia-MO,B421,1,22,1,36,127,91
PI606748,2018,Columbia-MO,B422,1,22,2,33,127,94
PI612594,2018,Columbia-MO,B423,1,22,3,34,124,90
PI612750,2018,Columbia-MO,B424,1,22,4,31,118,87
PI612932,2018,Columbia-MO,B425,1,22,5,34,117,83
PI614153,2018,Columbia-MO,B426,1,22,6,32,125,93
PI614154,2018,Columbia-MO,B427,1,22,7,31,121,90
PI614832,2018,Columbia-MO,B428,1,22,8,33,122,89
PI615555,2018,Columbia-MO,B429,1,22,9,35,122,87
PI633729,2018,Columbia-MO,B430,1,22,10,36,122,86
PI518671,2018,Columbia-MO,B431,1,22,11,38,127,89
PI633732,2018,Columbia-MO,B433,1,22,13,33,129,96
PI634761,2018,Columbia-MO,B434,1,22,14,35,122,87
PI634762,2018,Columbia-MO,B435,1,22,15,45,138,93
PI634763,2018,Columbia-MO,B436,1,22,16,43,137,94
PI634764,2018,Columbia-MO,B437,1,22,17,38,125,87
PI634765,2018,Columbia-MO,B438,1,22,18,43,131,88
PI636464,2018,Columbia-MO,B439,1,22,19,35,125,90
PI636695,2018,Columbia-MO,B440,1,22,20,41,140,99
PI548574,2018,Columbia-MO,B442,1,23,2,36,117,81
PI548622,2018,Columbia-MO,B443,1,23,3,36,124,88
PI548634,2018,Columbia-MO,B446,1,23,6,36,119,83
PI598124,2018,Columbia-MO,B447,1,23,7,31,125,94
PI518671,2018,Columbia-MO,B448,1,23,8,39,133,94
PI639740,2018,Columbia-MO,B450,1,23,10,37,130,93
PI643146,2018,Columbia-MO,B451,1,23,11,36,129,93
PI518671,2018,Columbia-MO,B452,1,23,12,40,133,93
PI398881,2018,Columbia-MO,B5,1,1,5,46,128,82
PI518671,2018,Columbia-MO,B51,1,3,11,43,135,92
PI424159B,2018,Columbia-MO,B6,1,1,6,48,136,88
PI518671,2018,Columbia-MO,B62,1,4,2,41,136,95
PI424405A,2018,Columbia-MO,B7,1,1,7,41,128,87
PI424405B,2018,Columbia-MO,B8,1,1,8,44,136,92
PI547477,2018,Columbia-MO,B88,1,5,8,44,133,89
PI518671,2018,Columbia-MO,B89,1,5,9,38,135,97
PI432359,2018,Columbia-MO,B9,1,1,9,38,133,95
PI547484,2018,Columbia-MO,B97,1,5,17,37,125,88
PI437903,2017,ACRE-IN,C100,1,12,5,54,114,60
PI596407,2017,ACRE-IN,C101,1,13,5,49,117,68
PI438341,2017,ACRE-IN,C102,1,14,5,37,114,77
PI586980,2017,ACRE-IN,C104,1,16,5,43,115,72
PI547814,2017,ACRE-IN,C106,1,18,5,45,114,69
PI547811,2017,ACRE-IN,C107,1,19,5,43,114,71
PI475822C,2017,ACRE-IN,C110,1,22,5,51,117,66
PI547847,2017,ACRE-IN,C113,1,20,6,43,117,74
PI283331,2017,ACRE-IN,C115,1,18,6,47,116,69
PI507708,2017,ACRE-IN,C118,1,15,6,43,117,74
PI438357B,2017,ACRE-IN,C119,1,14,6,45,115,70
PI437422,2017,ACRE-IN,C120,1,13,6,45,116,71
PI542044,2017,ACRE-IN,C123,1,10,6,43,117,74
PI591509,2017,ACRE-IN,C126,1,7,6,43,118,75
PI591506,2017,ACRE-IN,C127,1,6,6,42,117,75
PI612932,2017,ACRE-IN,C129,1,4,6,42,114,72
PI591528,2017,ACRE-IN,C130,1,3,6,46,116,70
PI595926,2017,ACRE-IN,C132,1,1,6,42,114,72
PI603434,2017,ACRE-IN,C133,1,1,7,43,114,71
PI591530,2017,ACRE-IN,C134,1,2,7,44,117,73
PI253660A,2017,ACRE-IN,C135,1,3,7,43,114,71
PI584470,2017,ACRE-IN,C137,1,5,7,45,119,74
PI547798,2017,ACRE-IN,C138,1,6,7,43,115,72
PI438079,2017,ACRE-IN,C139,1,7,7,45,115,70
PI591505,2017,ACRE-IN,C140,1,8,7,44,118,74
PI634763,2017,ACRE-IN,C141,1,9,7,47,117,70
PI548333,2017,ACRE-IN,C143,1,11,7,45,114,69
PI591504,2017,ACRE-IN,C145,1,13,7,43,118,75
PI591540,2017,ACRE-IN,C147,1,15,7,44,117,73
PI153243,2017,ACRE-IN,C148,1,16,7,46,114,68
PI591517,2017,ACRE-IN,C149,1,17,7,43,118,75
PI548262,2017,ACRE-IN,C151,1,19,7,42,117,75
PI437500C,2017,ACRE-IN,C152,1,20,7,43,115,72
PI574541,2017,ACRE-IN,C153,1,21,7,45,119,74
PI507692B,2017,ACRE-IN,C155,1,22,8,48,118,70
PI555396,2017,ACRE-IN,C156,1,21,8,43,118,75
PI603428D,2017,ACRE-IN,C157,1,20,8,45,117,72
PI548383,2017,ACRE-IN,C158,1,19,8,48,117,69
PI437103,2017,ACRE-IN,C159,1,18,8,49,114,65
PI591503,2017,ACRE-IN,C161,1,16,8,47,118,71
PI634764,2017,ACRE-IN,C162,1,15,8,45,118,73
PI437392,2017,ACRE-IN,C163,1,14,8,47,117,70
PI591507,2017,ACRE-IN,C164,1,13,8,46,118,72
PI427136,2017,ACRE-IN,C165,1,12,8,46,118,72
PI438310,2017,ACRE-IN,C166,1,11,8,53,114,61
PI437357,2017,ACRE-IN,C167,1,10,8,45,114,69
PI597387,2017,ACRE-IN,C168,1,9,8,42,117,75
PI636464,2017,ACRE-IN,C169,1,8,8,42,118,76
PI548635,2017,ACRE-IN,C170,1,7,8,43,117,74
PI548542,2017,ACRE-IN,C172,1,5,8,43,118,75
PI437641B,2017,ACRE-IN,C174,1,3,8,46,115,69
PI437461,2017,ACRE-IN,C175,1,2,8,48,114,66
PI591531,2017,ACRE-IN,C176,1,1,8,45,115,70
PI547886,2017,ACRE-IN,C178,1,2,9,43,118,75
PI612594,2017,ACRE-IN,C180,1,4,9,42,117,75
PI548381,2017,ACRE-IN,C185,1,9,9,44,114,70
PI615555,2017,ACRE-IN,C186,1,10,9,42,117,75
PI437359,2017,ACRE-IN,C187,1,11,9,48,115,67
PI556989,2017,ACRE-IN,C189,1,13,9,42,117,75
PI548242,2017,ACRE-IN,C191,1,15,9,42,118,76
PI548367,2017,ACRE-IN,C192,1,16,9,43,114,71
PI567404A,2017,ACRE-IN,C196,1,20,9,48,117,69
PI547869,2017,ACRE-IN,C197,1,21,9,43,118,75
PI634761,2017,ACRE-IN,C198,1,22,9,43,116,73
PI591532,2017,ACRE-IN,C199,1,22,10,43,118,75
PI437550C,2017,ACRE-IN,C200,1,21,10,43,114,71
PI548286,2017,ACRE-IN,C201,1,20,10,44,118,74
PI548275,2017,ACRE-IN,C202,1,19,10,43,118,75
PI437377,2017,ACRE-IN,C203,1,18,10,48,115,67
PI591519,2017,ACRE-IN,C208,1,13,10,43,118,75
PI534648,2017,ACRE-IN,C209,1,12,10,43,117,74
PI475822B,2017,ACRE-IN,C210,1,11,10,50,114,64
PI548204,2017,ACRE-IN,C211,1,10,10,52,117,65
PI591539,2017,ACRE-IN,C212,1,9,10,43,117,74
PI567351B,2017,ACRE-IN,C214,1,7,10,49,116,67
PI610670,2017,ACRE-IN,C215,1,6,10,42,114,72
PI437467,2017,ACRE-IN,C216,1,5,10,42,118,76
PI424405A,2017,ACRE-IN,C221,1,1,11,43,116,73
PI603186,2017,ACRE-IN,C222,1,2,11,60,122,62
PI591516,2017,ACRE-IN,C223,1,3,11,43,117,74
PI189935,2017,ACRE-IN,C224,1,4,11,43,116,73
PI548421,2017,ACRE-IN,C227,1,7,11,44,117,73
PI591521,2017,ACRE-IN,C228,1,8,11,46,118,72
PI189928,2017,ACRE-IN,C229,1,9,11,43,114,71
PI584441,2017,ACRE-IN,C23,1,22,2,43,118,75
PI547800,2017,ACRE-IN,C230,1,10,11,43,117,74
PI591538,2017,ACRE-IN,C231,1,11,11,43,117,74
PI574532,2017,ACRE-IN,C232,1,12,11,42,115,73
PI548558,2017,ACRE-IN,C233,1,13,11,44,117,73
PI437894,2017,ACRE-IN,C234,1,14,11,42,115,73
PI634765,2017,ACRE-IN,C235,1,15,11,43,117,74
PI603193,2017,ACRE-IN,C236,1,16,11,54,120,66
PI603188,2017,ACRE-IN,C239,1,19,11,50,119,69
PI438409,2017,ACRE-IN,C24,1,21,2,45,114,69
PI547802,2017,ACRE-IN,C240,1,20,11,43,117,74
PI591536,2017,ACRE-IN,C241,1,21,11,45,118,73
PI591537,2017,ACRE-IN,C242,1,22,11,45,118,73
PI253661B,2017,ACRE-IN,C244,1,21,12,48,114,66
PI548614,2017,ACRE-IN,C245,1,20,12,43,114,71
PI370055,2017,ACRE-IN,C246,1,19,12,43,114,71
PI548652,2017,ACRE-IN,C248,1,17,12,43,117,74
PI614153,2017,ACRE-IN,C250,1,15,12,42,118,76
PI542711,2017,ACRE-IN,C251,1,14,12,42,117,75
PI547860,2017,ACRE-IN,C253,1,12,12,42,117,75
PI438252C,2017,ACRE-IN,C255,1,10,12,44,117,73
PI591518,2017,ACRE-IN,C256,1,9,12,43,118,75
PI578057,2017,ACRE-IN,C258,1,7,12,44,119,75
PI561330A,2017,ACRE-IN,C259,1,6,12,44,118,74
PI534645,2017,ACRE-IN,C261,1,4,12,43,115,72
PI547885,2017,ACRE-IN,C262,1,3,12,43,114,71
PI548525,2017,ACRE-IN,C263,1,2,12,44,114,70
PI564718,2017,ACRE-IN,C264,1,1,12,43,116,73
PI612750,2017,ACRE-IN,C265,1,1,13,37,114,77
PI606748,2017,ACRE-IN,C266,1,2,13,42,118,76
PI437444,2017,ACRE-IN,C267,1,3,13,43,117,74
PI591510,2017,ACRE-IN,C268,1,4,13,43,117,74
PI603442,2017,ACRE-IN,C27,1,18,2,42,114,72
PI548632,2017,ACRE-IN,C272,1,8,13,42,114,72
PI542043,2017,ACRE-IN,C273,1,9,13,43,117,74
PI548412,2017,ACRE-IN,C275,1,11,13,43,114,71
PI547484,2017,ACRE-IN,C276,1,12,13,43,117,74
PI590932,2017,ACRE-IN,C285,1,21,13,43,121,78
PI533654,2017,ACRE-IN,C287,1,22,14,42,118,76
PI404173B,2017,ACRE-IN,C289,1,20,14,51,122,71
PI437412,2017,ACRE-IN,C29,1,16,2,43,115,72
PI547500,2017,ACRE-IN,C290,1,19,14,46,118,72
PI417573,2017,ACRE-IN,C298,1,11,14,43,114,71
PI437487,2017,ACRE-IN,C300,1,9,14,47,114,67
PI574534,2017,ACRE-IN,C301,1,8,14,38,116,78
PI548180,2017,ACRE-IN,C302,1,7,14,43,114,71
PI561321,2017,ACRE-IN,C304,1,5,14,45,114,69
PI548304,2017,ACRE-IN,C305,1,4,14,42,114,72
PI547864,2017,ACRE-IN,C307,1,2,14,43,114,71
PI548585,2017,ACRE-IN,C308,1,1,14,44,115,71
PI437464,2017,ACRE-IN,C31,1,14,2,42,118,76
PI209331,2017,ACRE-IN,C313,1,5,15,43,117,74
PI548340,2017,ACRE-IN,C314,1,6,15,43,114,71
PI438486,2017,ACRE-IN,C315,1,7,15,53,116,63
PI591526,2017,ACRE-IN,C316,1,8,15,43,117,74
PI548198,2017,ACRE-IN,C318,1,10,15,61,117,56
PI593258,2017,ACRE-IN,C319,1,11,15,42,117,75
PI248402,2017,ACRE-IN,C324,1,16,15,51,122,71
PI548546,2017,ACRE-IN,C328,1,20,15,48,120,72
PI560207,2017,ACRE-IN,C336,1,17,16,46,121,75
PI548532,2017,ACRE-IN,C338,1,15,16,45,118,73
PI548541,2017,ACRE-IN,C340,1,13,16,51,136,85
PI614154,2017,ACRE-IN,C35,1,10,2,42,118,76
PI606749,2017,ACRE-IN,C354,1,2,17,43,135,92
PI591492,2017,ACRE-IN,C355,1,3,17,48,120,72
PI538401B,2017,ACRE-IN,C359,1,7,17,42,119,77
PI398881,2017,ACRE-IN,C36,1,9,2,42,117,75
PI548174,2017,ACRE-IN,C363,1,11,17,44,117,73
PI424159B,2017,ACRE-IN,C364,1,12,17,42,135,93
PI636695,2017,ACRE-IN,C365,1,13,17,50,114,64
PI518667,2017,ACRE-IN,C366,1,14,17,46,134,88
PI603205,2017,ACRE-IN,C367,1,15,17,48,136,88
PI189926,2017,ACRE-IN,C368,1,16,17,45,117,72
PI593463,2017,ACRE-IN,C37,1,8,2,41,117,76
PI615556,2017,ACRE-IN,C370,1,18,17,46,114,68
PI548547,2017,ACRE-IN,C375,1,1,18,46,137,91
PI603564A,2017,ACRE-IN,C376,1,2,18,54,136,82
PI547655,2017,ACRE-IN,C377,1,3,18,46,136,90
PI591490,2017,ACRE-IN,C381,1,7,18,46,136,90
PI548678,2017,ACRE-IN,C383,1,9,18,56,134,78
PI555399,2017,ACRE-IN,C387,1,13,18,53,138,85
PI540555,2017,ACRE-IN,C389,1,15,18,43,118,75
PI592946,2017,ACRE-IN,C391,1,17,18,50,134,84
PI591494,2017,ACRE-IN,C395,1,21,18,45,135,90
PI603564B,2017,ACRE-IN,C396,1,22,18,53,134,81
PI548177,2017,ACRE-IN,C399,1,3,19,43,135,92
PI548231,2017,ACRE-IN,C401,1,5,19,53,134,81
PI547663,2017,ACRE-IN,C407,1,11,19,42,117,75
PI518673,2017,ACRE-IN,C414,1,18,19,44,135,91
PI602450,2017,ACRE-IN,C419,1,22,20,52,137,85
PI548562,2017,ACRE-IN,C42,1,3,2,42,114,72
PI437397,2017,ACRE-IN,C423,1,18,20,41,115,74
PI371611,2017,ACRE-IN,C432,1,9,20,45,135,90
PI603571B,2017,ACRE-IN,C439,1,2,20,42,135,93
PI591513,2017,ACRE-IN,C44,1,1,2,43,119,76
PI560206,2017,ACRE-IN,C442,1,2,21,45,134,89
PI547598,2017,ACRE-IN,C443,1,3,21,46,135,89
PI593654,2017,ACRE-IN,C446,1,6,21,44,136,92
PI548400,2017,ACRE-IN,C449,1,9,21,43,116,73
PI548636,2017,ACRE-IN,C454,1,14,21,45,133,88
PI577798,2017,ACRE-IN,C455,1,15,21,46,137,91
PI424405B,2017,ACRE-IN,C456,1,16,21,50,136,86
PI591498,2017,ACRE-IN,C458,1,18,21,46,134,88
PI591495,2017,ACRE-IN,C459,1,19,21,51,133,82
PI636696,2017,ACRE-IN,C463,1,22,22,54,138,84
PI567767B,2017,ACRE-IN,C465,1,20,22,43,134,91
PI547471,2017,ACRE-IN,C470,1,15,22,48,136,88
PI170380,2017,ACRE-IN,C471,1,14,22,46,117,71
PI432359,2017,ACRE-IN,C475,1,10,22,46,135,89
PI515961,2017,ACRE-IN,C477,1,8,22,46,139,93
PI437459,2017,ACRE-IN,C48,1,4,3,47,118,71
PI595363,2017,ACRE-IN,C480,1,5,22,43,135,92
PI547617,2017,ACRE-IN,C481,1,4,22,46,136,90
PI603915D,2017,ACRE-IN,C483,1,2,22,46,135,89
PI518668,2017,ACRE-IN,C484,1,1,22,46,134,88
PI602449,2017,ACRE-IN,C485,1,1,23,48,135,87
PI567527,2017,ACRE-IN,C487,1,3,23,49,136,87
PI603396,2017,ACRE-IN,C49,1,5,3,47,118,71
PI591493,2017,ACRE-IN,C491,1,7,23,46,136,90
PI548633,2017,ACRE-IN,C493,1,9,23,46,135,89
PI548555,2017,ACRE-IN,C495,1,11,23,44,138,94
PI543793,2017,ACRE-IN,C498,1,14,23,45,138,93
PI548373,2017,ACRE-IN,C50,1,6,3,43,118,75
PI548598,2017,ACRE-IN,C504,1,20,23,43,134,91
PI614155,2017,ACRE-IN,C505,1,21,23,43,134,91
PI548247,2017,ACRE-IN,C513,1,16,24,43,135,92
PI597382,2017,ACRE-IN,C516,1,13,24,46,134,88
PI603564C,2017,ACRE-IN,C517,1,12,24,50,133,83
PI591497,2017,ACRE-IN,C518,1,11,24,46,134,88
PI595754,2017,ACRE-IN,C52,1,8,3,45,117,72
PI548410,2017,ACRE-IN,C528,1,1,24,46,137,91
PI547657,2017,ACRE-IN,C529,1,1,25,46,135,89
PI548543,2017,ACRE-IN,C530,1,2,25,43,135,92
PI547545,2017,ACRE-IN,C531,1,3,25,46,134,88
PI548250,2017,ACRE-IN,C532,1,4,25,50,140,90
PI548222,2017,ACRE-IN,C533,1,5,25,48,140,92
PI548613,2017,ACRE-IN,C534,1,6,25,51,139,88
PI518675,2017,ACRE-IN,C54,1,10,3,43,116,73
PI548192,2017,ACRE-IN,C543,1,15,25,49,136,87
PI548517,2017,ACRE-IN,C549,1,21,25,43,135,92
PI437367,2017,ACRE-IN,C55,1,11,3,46,117,71
PI633732,2017,ACRE-IN,C551,1,22,26,42,135,93
PI591499,2017,ACRE-IN,C552,1,21,26,46,136,90
PI603454,2017,ACRE-IN,C553,1,20,26,46,118,72
PI525454,2017,ACRE-IN,C554,1,19,26,43,118,75
PI548194,2017,ACRE-IN,C555,1,18,26,46,122,76
PI593256,2017,ACRE-IN,C558,1,15,26,43,136,93
PI547477,2017,ACRE-IN,C559,1,14,26,45,135,90
PI548191,2017,ACRE-IN,C562,1,11,26,52,135,83
PI548549,2017,ACRE-IN,C563,1,10,26,44,137,93
PI559931,2017,ACRE-IN,C566,1,7,26,46,136,90
PI591533,2017,ACRE-IN,C57,1,13,3,46,117,71
PI548339,2017,ACRE-IN,C570,1,3,26,52,137,85
PI548297,2017,ACRE-IN,C571,1,2,26,48,135,87
PI642055,2017,ACRE-IN,C576,1,4,27,53,138,85
PI547501,2017,ACRE-IN,C578,1,6,27,45,135,90
PI633729,2017,ACRE-IN,C58,1,14,3,43,118,75
PI518663,2017,ACRE-IN,C580,1,8,27,58,140,82
PI548602,2017,ACRE-IN,C581,1,9,27,51,139,88
PI547497,2017,ACRE-IN,C582,1,10,27,45,135,90
PI548193,2017,ACRE-IN,C584,1,12,27,51,136,85
PI548603,2017,ACRE-IN,C587,1,15,27,49,138,89
PI603201,2017,ACRE-IN,C588,1,16,27,59,136,77
PI437388,2017,ACRE-IN,C59,1,15,3,59,114,55
PI556814,2017,ACRE-IN,C596,1,21,28,42,118,76
PI576160,2017,ACRE-IN,C600,1,17,28,42,114,72
PI556932,2017,ACRE-IN,C605,1,12,28,49,136,87
PI556780,2017,ACRE-IN,C606,1,11,28,45,135,90
PI556889,2017,ACRE-IN,C607,1,10,28,45,136,91
PI556931,2017,ACRE-IN,C608,1,9,28,43,115,72
PI556687,2017,ACRE-IN,C609,1,8,28,45,135,90
PI591561,2017,ACRE-IN,C610,1,7,28,42,115,73
PI556511,2017,ACRE-IN,C611,1,6,28,36,114,78
PI556778,2017,ACRE-IN,C612,1,5,28,38,114,76
PI568245,2017,ACRE-IN,C613,1,4,28,43,135,92
PI576166,2017,ACRE-IN,C614,1,3,28,43,136,93
PI556572,2017,ACRE-IN,C615,1,2,28,43,136,93
PI556816,2017,ACRE-IN,C616,1,1,28,42,136,94
PI548682,2017,ACRE-IN,C618,1,2,29,44,134,90
PI548671,2017,ACRE-IN,C619,1,3,29,52,134,82
PI153292,2017,ACRE-IN,C62,1,18,3,45,114,69
PI548685,2017,ACRE-IN,C621,1,5,29,45,136,91
PI548670,2017,ACRE-IN,C623,1,7,29,43,114,71
PI556859,2017,ACRE-IN,C624,1,8,29,43,116,73
PI548679,2017,ACRE-IN,C626,1,10,29,43,136,93
PI556781,2017,ACRE-IN,C627,1,11,29,43,115,72
PI556928,2017,ACRE-IN,C630,1,14,29,46,114,68
PI534646,2017,ACRE-IN,C631,1,15,29,43,114,71
PI556857,2017,ACRE-IN,C632,1,16,29,43,133,90
PI548684,2017,ACRE-IN,C634,1,18,29,42,114,72
PI548686,2017,ACRE-IN,C635,1,19,29,43,114,71
PI437711B,2017,ACRE-IN,C638,1,22,29,50,116,66
PI479740,2017,ACRE-IN,C65,1,21,3,44,118,74
PI547879,2017,ACRE-IN,C66,1,22,3,46,121,75
PI591535,2017,ACRE-IN,C67,1,22,4,43,115,72
PI567366A,2017,ACRE-IN,C69,1,20,4,58,117,59
PI437463B,2017,ACRE-IN,C70,1,19,4,40,114,74
PI591534,2017,ACRE-IN,C72,1,17,4,42,114,72
PI548522,2017,ACRE-IN,C73,1,16,4,47,117,70
PI552538,2017,ACRE-IN,C74,1,15,4,42,114,72
PI614832,2017,ACRE-IN,C77,1,12,4,42,117,75
PI548597,2017,ACRE-IN,C78,1,11,4,43,116,73
PI548366,2017,ACRE-IN,C79,1,10,4,43,112,69
PI507676,2017,ACRE-IN,C80,1,9,4,47,117,70
PI547876,2017,ACRE-IN,C81,1,8,4,45,117,72
PI591512,2017,ACRE-IN,C82,1,7,4,43,117,74
PI548365,2017,ACRE-IN,C83,1,6,4,38,112,74
PI542709,2017,ACRE-IN,C84,1,5,4,43,117,74
PI547813,2017,ACRE-IN,C85,1,4,4,43,113,70
PI437124,2017,ACRE-IN,C86,1,3,4,41,113,72
PI548267,2017,ACRE-IN,C88,1,1,4,50,120,70
PI634762,2017,ACRE-IN,C89,1,1,5,45,117,72
PI438124B,2017,ACRE-IN,C91,1,3,5,44,114,70
PI548253,2017,ACRE-IN,C92,1,4,5,44,117,73
PI547801,2017,ACRE-IN,C93,1,5,5,49,115,66
PI591515,2017,ACRE-IN,C96,1,8,5,43,115,72
PI437391,2017,ACRE-IN,C97,1,9,5,43,114,71
PI534647,2017,ACRE-IN,C99,1,11,5,43,115,72
PI584441,2018,ACRE-IN,D1,1,2,2,42,124,82
PI507676,2018,ACRE-IN,D100,1,17,6,37,120,83
PI614832,2018,ACRE-IN,D101,1,13,6,39,119,80
PI534647,2018,ACRE-IN,D102,1,14,6,41,120,79
PI591506,2018,ACRE-IN,D103,1,15,6,38,122,84
PI547813,2018,ACRE-IN,D106,1,19,6,44,119,75
PI548365,2018,ACRE-IN,D107,1,20,6,44,118,74
PI547801,2018,ACRE-IN,D108,1,21,6,50,124,74
PI548267,2018,ACRE-IN,D109,1,22,6,49,125,76
PI633732,2018,ACRE-IN,D11,1,12,2,39,126,87
PI548597,2018,ACRE-IN,D110,1,23,6,39,117,78
PI437641B,2018,ACRE-IN,D111,1,23,7,40,118,78
PI437461,2018,ACRE-IN,D112,1,22,7,47,119,72
PI548366,2018,ACRE-IN,D113,1,21,7,44,117,73
PI548381,2018,ACRE-IN,D114,1,20,7,41,118,77
PI591531,2018,ACRE-IN,D116,1,18,7,42,124,82
PI591528,2018,ACRE-IN,D117,1,17,7,43,127,84
PI634762,2018,ACRE-IN,D118,1,16,7,46,126,80
PI591505,2018,ACRE-IN,D119,1,15,7,42,121,79
PI556572,2018,ACRE-IN,D12,1,13,2,40,124,84
PI603434,2018,ACRE-IN,D120,1,14,7,43,118,75
PI634763,2018,ACRE-IN,D122,1,12,7,43,131,88
PI556931,2018,ACRE-IN,D124,1,10,7,37,122,85
PI597387,2018,ACRE-IN,D126,1,8,7,41,122,81
PI548242,2018,ACRE-IN,D127,1,7,7,43,122,79
PI576160,2018,ACRE-IN,D128,1,6,7,41,121,80
PI603396,2018,ACRE-IN,D13,1,14,2,50,117,67
PI437359,2018,ACRE-IN,D131,1,3,7,43,116,73
PI591530,2018,ACRE-IN,D132,1,2,7,41,122,81
PI548262,2018,ACRE-IN,D135,1,4,8,42,126,84
PI634764,2018,ACRE-IN,D136,1,5,8,49,122,73
PI547886,2018,ACRE-IN,D137,1,6,8,42,125,83
PI591540,2018,ACRE-IN,D139,1,8,8,41,120,79
PI437367,2018,ACRE-IN,D14,1,15,2,47,127,80
PI612594,2018,ACRE-IN,D140,1,9,8,39,122,83
PI427136,2018,ACRE-IN,D141,1,10,8,46,119,73
PI548635,2018,ACRE-IN,D142,1,11,8,43,121,78
PI437392,2018,ACRE-IN,D143,1,12,8,44,119,75
PI591515,2018,ACRE-IN,D144,1,13,8,41,127,86
PI438124B,2018,ACRE-IN,D145,1,14,8,45,121,76
PI253660A,2018,ACRE-IN,D146,1,15,8,43,116,73
PI438310,2018,ACRE-IN,D148,1,17,8,49,119,70
PI548679,2018,ACRE-IN,D151,1,20,8,49,132,83
PI547798,2018,ACRE-IN,D152,1,21,8,42,119,77
PI548333,2018,ACRE-IN,D153,1,22,8,40,122,82
PI438079,2018,ACRE-IN,D154,1,23,8,41,118,77
PI591512,2018,ACRE-IN,D155,1,23,9,40,125,85
PI636464,2018,ACRE-IN,D156,1,22,9,43,125,82
PI547876,2018,ACRE-IN,D158,1,20,9,42,122,80
PI615555,2018,ACRE-IN,D159,1,19,9,43,122,79
PI595754,2018,ACRE-IN,D16,1,17,2,43,119,76
PI548603,2018,ACRE-IN,D160,1,18,9,47,127,80
PI437357,2018,ACRE-IN,D166,1,12,9,43,121,78
PI437103,2018,ACRE-IN,D168,1,10,9,49,116,67
PI437500C,2018,ACRE-IN,D169,1,9,9,37,116,79
PI556989,2018,ACRE-IN,D170,1,8,9,41,118,77
PI548383,2018,ACRE-IN,D171,1,7,9,44,118,74
PI591503,2018,ACRE-IN,D172,1,6,9,44,125,81
PI603454,2018,ACRE-IN,D173,1,5,9,43,127,84
PI548542,2018,ACRE-IN,D175,1,3,9,41,122,81
PI567404A,2018,ACRE-IN,D176,1,2,9,46,120,74
PI548614,2018,ACRE-IN,D177,1,2,10,40,119,79
PI591517,2018,ACRE-IN,D178,1,3,10,44,126,82
PI603428D,2018,ACRE-IN,D179,1,4,10,47,116,69
PI548373,2018,ACRE-IN,D18,1,19,2,47,122,75
PI547869,2018,ACRE-IN,D181,1,6,10,44,127,83
PI548670,2018,ACRE-IN,D182,1,7,10,46,118,72
PI591537,2018,ACRE-IN,D183,1,8,10,42,124,82
PI548193,2018,ACRE-IN,D184,1,9,10,50,125,75
PI547860,2018,ACRE-IN,D185,1,10,10,44,122,78
PI507696C,2018,ACRE-IN,D187,1,12,10,42,122,80
PI437550C,2018,ACRE-IN,D188,1,13,10,44,119,75
PI253661B,2018,ACRE-IN,D189,1,14,10,45,117,72
PI398881,2018,ACRE-IN,D19,1,20,2,43,119,76
PI561330A,2018,ACRE-IN,D190,1,15,10,43,116,73
PI556814,2018,ACRE-IN,D191,1,16,10,42,133,91
PI603193,2018,ACRE-IN,D192,1,17,10,51,134,83
PI614153,2018,ACRE-IN,D193,1,18,10,40,130,90
PI603188,2018,ACRE-IN,D194,1,19,10,44,134,90
PI547800,2018,ACRE-IN,D197,1,22,10,44,124,80
PI437377,2018,ACRE-IN,D198,1,23,10,43,116,73
PI610670,2018,ACRE-IN,D199,1,23,11,42,122,80
PI548562,2018,ACRE-IN,D20,1,21,2,40,117,77
PI591518,2018,ACRE-IN,D200,1,22,11,41,129,88
PI634765,2018,ACRE-IN,D201,1,21,11,42,125,83
PI574532,2018,ACRE-IN,D203,1,19,11,41,126,85
PI548652,2018,ACRE-IN,D205,1,17,11,41,126,85
PI591532,2018,ACRE-IN,D208,1,14,11,41,125,84
PI548558,2018,ACRE-IN,D209,1,13,11,43,121,78
PI591507,2018,ACRE-IN,D210,1,12,11,43,121,78
PI547802,2018,ACRE-IN,D211,1,11,11,47,122,75
PI437894,2018,ACRE-IN,D212,1,10,11,45,123,78
PI574541,2018,ACRE-IN,D213,1,9,11,44,127,83
PI634761,2018,ACRE-IN,D214,1,8,11,50,127,77
PI153243,2018,ACRE-IN,D216,1,6,11,47,115,68
PI548367,2018,ACRE-IN,D219,1,3,11,41,118,77
PI437459,2018,ACRE-IN,D22,1,23,2,41,125,84
PI507692B,2018,ACRE-IN,D220,1,2,11,43,117,74
PI591519,2018,ACRE-IN,D222,1,3,12,43,124,81
PI437500B,2018,ACRE-IN,D223,1,4,12,43,117,74
PI555396,2018,ACRE-IN,D224,1,5,12,46,131,85
PI542711,2018,ACRE-IN,D225,1,6,12,45,129,84
PI591504,2018,ACRE-IN,D226,1,7,12,46,125,79
PI437338,2018,ACRE-IN,D230,1,11,12,44,118,74
PI534648,2018,ACRE-IN,D231,1,12,12,36,124,88
PI591561,2018,ACRE-IN,D232,1,13,12,40,122,82
PI548525,2018,ACRE-IN,D237,1,18,12,46,121,75
PI591536,2018,ACRE-IN,D239,1,20,12,41,132,91
PI614154,2018,ACRE-IN,D24,1,22,3,37,117,80
PI548275,2018,ACRE-IN,D240,1,21,12,42,130,88
PI370055,2018,ACRE-IN,D242,1,23,12,44,117,73
PI591516,2018,ACRE-IN,D243,1,23,13,41,130,89
PI547864,2018,ACRE-IN,D244,1,22,13,40,126,86
PI578057,2018,ACRE-IN,D245,1,21,13,44,125,81
PI438252C,2018,ACRE-IN,D246,1,20,13,43,119,76
PI567351B,2018,ACRE-IN,D247,1,19,13,46,129,83
PI437444,2018,ACRE-IN,D248,1,18,13,44,123,79
PI437467,2018,ACRE-IN,D249,1,17,13,41,120,79
PI424405A,2018,ACRE-IN,D250,1,16,13,40,126,86
PI591510,2018,ACRE-IN,D252,1,14,13,45,122,77
PI591538,2018,ACRE-IN,D253,1,13,13,43,125,82
PI437487,2018,ACRE-IN,D257,1,9,13,47,117,70
PI612750,2018,ACRE-IN,D258,1,8,13,41,122,81
PI593258,2018,ACRE-IN,D259,1,7,13,41,122,81
PI593463,2018,ACRE-IN,D26,1,20,3,43,121,78
PI209331,2018,ACRE-IN,D260,1,6,13,44,121,77
PI542043,2018,ACRE-IN,D261,1,5,13,44,126,82
PI606748,2018,ACRE-IN,D263,1,3,13,41,132,91
PI548180,2018,ACRE-IN,D267,1,4,14,48,118,70
PI438486,2018,ACRE-IN,D268,1,5,14,48,120,72
PI548686,2018,ACRE-IN,D269,1,6,14,45,121,76
PI548304,2018,ACRE-IN,D271,1,8,14,43,116,73
PI561321,2018,ACRE-IN,D273,1,10,14,44,120,76
PI548585,2018,ACRE-IN,D275,1,12,14,44,125,81
PI603186,2018,ACRE-IN,D276,1,13,14,55,142,87
PI548421,2018,ACRE-IN,D278,1,15,14,45,120,75
PI591539,2018,ACRE-IN,D279,1,16,14,43,122,79
PI518675,2018,ACRE-IN,D28,1,18,3,41,117,76
PI564718,2018,ACRE-IN,D283,1,20,14,43,126,83
PI556511,2018,ACRE-IN,D288,1,22,15,41,118,77
PI547885,2018,ACRE-IN,D289,1,21,15,43,125,82
PI591499,2018,ACRE-IN,D29,1,17,3,46,118,72
PI591521,2018,ACRE-IN,D291,1,19,15,41,126,85
PI189928,2018,ACRE-IN,D292,1,18,15,42,116,74
PI475822B,2018,ACRE-IN,D293,1,17,15,44,122,78
PI548204,2018,ACRE-IN,D294,1,16,15,50,118,68
PI548412,2018,ACRE-IN,D295,1,15,15,43,122,79
PI189935,2018,ACRE-IN,D296,1,14,15,45,122,77
PI534645,2018,ACRE-IN,D297,1,13,15,38,122,84
PI547879,2018,ACRE-IN,D3,1,4,2,44,126,82
PI574534,2018,ACRE-IN,D300,1,10,15,39,122,83
PI548632,2018,ACRE-IN,D301,1,9,15,48,119,71
PI417573,2018,ACRE-IN,D303,1,7,15,45,116,71
PI591526,2018,ACRE-IN,D305,1,5,15,46,122,76
PI556889,2018,ACRE-IN,D307,1,3,15,44,132,88
PI548340,2018,ACRE-IN,D308,1,2,15,42,118,76
PI590932,2018,ACRE-IN,D315,1,8,16,50,132,82
PI548260,2018,ACRE-IN,D320,1,13,16,57,134,77
PI560207,2018,ACRE-IN,D321,1,14,16,50,132,82
PI603201,2018,ACRE-IN,D322,1,15,16,57,140,83
PI603564B,2018,ACRE-IN,D323,1,16,16,51,131,80
PI548541,2018,ACRE-IN,D328,1,21,16,48,134,86
PI603205,2018,ACRE-IN,D329,1,22,16,47,129,82
PI417526,2018,ACRE-IN,D33,1,13,3,44,116,72
PI636695,2018,ACRE-IN,D332,1,22,17,46,131,85
PI189926,2018,ACRE-IN,D337,1,17,17,46,122,76
PI424159B,2018,ACRE-IN,D338,1,16,17,46,130,84
PI540555,2018,ACRE-IN,D340,1,14,17,44,130,86
PI248402,2018,ACRE-IN,D343,1,11,17,51,133,82
PI593256,2018,ACRE-IN,D349,1,5,17,47,130,83
PI633729,2018,ACRE-IN,D35,1,11,3,44,124,80
PI548546,2018,ACRE-IN,D350,1,4,17,52,130,78
PI592946,2018,ACRE-IN,D355,1,4,18,44,120,76
PI555399,2018,ACRE-IN,D358,1,7,18,52,142,90
PI615556,2018,ACRE-IN,D359,1,8,18,47,124,77
PI591533,2018,ACRE-IN,D36,1,10,3,40,124,84
PI404173B,2018,ACRE-IN,D366,1,15,18,51,130,79
PI547484,2018,ACRE-IN,D367,1,16,18,45,122,77
PI437464,2018,ACRE-IN,D37,1,9,3,43,128,85
PI533654,2018,ACRE-IN,D370,1,19,18,45,130,85
PI547500,2018,ACRE-IN,D371,1,20,18,44,122,78
PI556687,2018,ACRE-IN,D372,1,21,18,40,120,80
PI538401B,2018,ACRE-IN,D375,1,23,19,43,122,79
PI556780,2018,ACRE-IN,D376,1,22,19,41,130,89
PI591494,2018,ACRE-IN,D379,1,19,19,41,125,84
PI479740,2018,ACRE-IN,D38,1,8,3,39,122,83
PI591490,2018,ACRE-IN,D384,1,14,19,50,134,84
PI591492,2018,ACRE-IN,D386,1,12,19,46,121,75
PI556928,2018,ACRE-IN,D387,1,11,19,49,130,81
PI437365,2018,ACRE-IN,D39,1,7,3,44,117,73
PI606749,2018,ACRE-IN,D390,1,8,19,48,139,91
PI371611,2018,ACRE-IN,D396,1,2,19,44,121,77
PI593654,2018,ACRE-IN,D397,1,2,20,39,118,79
PI534646,2018,ACRE-IN,D4,1,5,2,40,127,87
PI153292,2018,ACRE-IN,D40,1,6,3,39,119,80
PI547655,2018,ACRE-IN,D400,1,5,20,46,127,81
PI548400,2018,ACRE-IN,D403,1,8,20,43,120,77
PI548547,2018,ACRE-IN,D417,1,22,20,44,122,78
PI548174,2018,ACRE-IN,D419,1,23,21,42,120,78
PI576166,2018,ACRE-IN,D42,1,4,3,41,130,89
PI603564A,2018,ACRE-IN,D422,1,20,21,48,119,71
PI548678,2018,ACRE-IN,D424,1,18,21,54,130,76
PI556857,2018,ACRE-IN,D425,1,17,21,43,129,86
PI548532,2018,ACRE-IN,D429,1,13,21,44,126,82
PI438409,2018,ACRE-IN,D43,1,3,3,47,118,71
PI547598,2018,ACRE-IN,D430,1,12,21,47,130,83
PI603571B,2018,ACRE-IN,D437,1,5,21,41,128,87
PI560206,2018,ACRE-IN,D439,1,3,21,42,128,86
PI591513,2018,ACRE-IN,D44,1,2,3,38,122,84
PI568245,2018,ACRE-IN,D440,1,2,21,39,126,87
PI548636,2018,ACRE-IN,D444,1,5,22,42,131,89
PI547663,2018,ACRE-IN,D445,1,6,22,42,123,81
PI577798,2018,ACRE-IN,D447,1,8,22,41,134,93
PI437422,2018,ACRE-IN,D45,1,2,4,47,122,75
PI424405B,2018,ACRE-IN,D451,1,12,22,46,129,83
PI597382,2018,ACRE-IN,D459,1,20,22,40,130,90
PI636696,2018,ACRE-IN,D460,1,21,22,49,139,90
PI170380,2018,ACRE-IN,D461,1,22,22,44,119,75
PI602450,2018,ACRE-IN,D470,1,16,23,47,117,70
PI567767B,2018,ACRE-IN,D471,1,15,23,43,126,83
PI543793,2018,ACRE-IN,D472,1,14,23,45,135,90
PI548231,2018,ACRE-IN,D475,1,11,23,40,121,81
PI475822C,2018,ACRE-IN,D48,1,5,4,54,129,75
PI556816,2018,ACRE-IN,D485,1,2,24,41,123,82
PI548177,2018,ACRE-IN,D489,1,6,24,49,125,76
PI547811,2018,ACRE-IN,D49,1,6,4,40,119,79
PI591495,2018,ACRE-IN,D490,1,7,24,48,130,82
PI437397,2018,ACRE-IN,D492,1,9,24,42,122,80
PI591498,2018,ACRE-IN,D493,1,10,24,45,130,85
PI548598,2018,ACRE-IN,D497,1,14,24,46,130,84
PI547814,2018,ACRE-IN,D50,1,7,4,44,120,76
PI548684,2018,ACRE-IN,D503,1,20,24,43,122,79
PI518673,2018,ACRE-IN,D506,1,23,24,43,122,79
PI602449,2018,ACRE-IN,D509,1,21,25,45,129,84
PI283331,2018,ACRE-IN,D51,1,8,4,44,119,75
PI548247,2018,ACRE-IN,D510,1,20,25,43,121,78
PI547617,2018,ACRE-IN,D516,1,14,25,46,126,80
PI507708,2018,ACRE-IN,D52,1,9,4,45,118,73
PI547501,2018,ACRE-IN,D521,1,9,25,40,121,81
PI548671,2018,ACRE-IN,D526,1,4,25,49,121,72
PI548191,2018,ACRE-IN,D528,1,2,25,46,122,76
PI591493,2018,ACRE-IN,D531,1,4,26,46,121,75
PI548555,2018,ACRE-IN,D533,1,6,26,41,131,90
PI548339,2018,ACRE-IN,D535,1,8,26,47,122,75
PI518668,2018,ACRE-IN,D536,1,9,26,46,139,93
PI559931,2018,ACRE-IN,D537,1,10,26,41,126,85
PI515961,2018,ACRE-IN,D538,1,11,26,46,139,93
PI438341,2018,ACRE-IN,D54,1,11,4,40,117,77
PI591497,2018,ACRE-IN,D542,1,15,26,42,129,87
PI548682,2018,ACRE-IN,D543,1,16,26,43,128,85
PI432359,2018,ACRE-IN,D544,1,17,26,47,129,82
PI595363,2018,ACRE-IN,D546,1,19,26,40,116,76
PI547471,2018,ACRE-IN,D547,1,20,26,47,127,80
PI614155,2018,ACRE-IN,D549,1,22,26,36,131,95
PI603564C,2018,ACRE-IN,D554,1,20,27,49,122,73
PI603915D,2018,ACRE-IN,D555,1,19,27,42,130,88
PI542709,2018,ACRE-IN,D56,1,13,4,41,117,76
PI567527,2018,ACRE-IN,D563,1,11,27,47,130,83
PI548410,2018,ACRE-IN,D566,1,8,27,46,122,76
PI548633,2018,ACRE-IN,D569,1,5,27,42,116,74
PI567366A,2018,ACRE-IN,D57,1,14,4,54,122,68
PI556778,2018,ACRE-IN,D573,1,2,28,44,129,85
PI547497,2018,ACRE-IN,D574,1,3,28,45,128,83
PI548518,2018,ACRE-IN,D575,1,4,28,46,120,74
PI556859,2018,ACRE-IN,D577,1,6,28,41,126,85
PI548253,2018,ACRE-IN,D58,1,15,4,40,122,82
PI548549,2018,ACRE-IN,D580,1,9,28,46,130,84
PI556932,2018,ACRE-IN,D582,1,11,28,48,134,86
PI642055,2018,ACRE-IN,D585,1,14,28,49,138,89
PI548192,2018,ACRE-IN,D586,1,15,28,51,131,80
PI525454,2018,ACRE-IN,D587,1,16,28,43,121,78
PI547477,2018,ACRE-IN,D589,1,18,28,46,127,81
PI437463B,2018,ACRE-IN,D59,1,16,4,41,117,76
PI548685,2018,ACRE-IN,D595,1,23,29,41,117,76
PI548194,2018,ACRE-IN,D599,1,19,29,44,129,85
PI591535,2018,ACRE-IN,D60,1,17,4,41,122,81
PI518663,2018,ACRE-IN,D601,1,17,29,40,118,78
PI556781,2018,ACRE-IN,D603,1,15,29,40,122,82
PI548517,2018,ACRE-IN,D605,1,13,29,41,130,89
PI548602,2018,ACRE-IN,D606,1,12,29,47,132,85
PI548250,2018,ACRE-IN,D607,1,11,29,49,136,87
PI548613,2018,ACRE-IN,D608,1,10,29,40,122,82
PI437124,2018,ACRE-IN,D61,1,18,4,42,118,76
PI548297,2018,ACRE-IN,D610,1,8,29,47,128,81
PI547657,2018,ACRE-IN,D612,1,6,29,44,126,82
PI547545,2018,ACRE-IN,D615,1,3,29,47,128,81
PI437391,2018,ACRE-IN,D62,1,19,4,43,119,76
PI612932,2018,ACRE-IN,D66,1,23,4,41,117,76
PI542044,2018,ACRE-IN,D67,1,23,5,41,123,82
PI595926,2018,ACRE-IN,D69,1,21,5,37,118,81
PI437317,2018,ACRE-IN,D71,1,19,5,40,117,77
PI548522,2018,ACRE-IN,D75,1,15,5,42,118,76
PI591509,2018,ACRE-IN,D77,1,13,5,41,122,81
PI437388,2018,ACRE-IN,D8,1,9,2,42,116,74
PI591534,2018,ACRE-IN,D81,1,9,5,39,119,80
PI603442,2018,ACRE-IN,D82,1,8,5,37,117,80
PI438500,2018,ACRE-IN,D84,1,6,5,43,124,81
PI552538,2018,ACRE-IN,D85,1,5,5,40,119,79
PI438357B,2018,ACRE-IN,D87,1,3,5,52,121,69
PI437903,2018,ACRE-IN,D90,1,3,6,46,118,72
PI547847,2018,ACRE-IN,D91,1,4,6,43,121,78
PI437412,2018,ACRE-IN,D93,1,6,6,43,117,74
PI596407,2018,ACRE-IN,D97,1,10,6,43,120,77
PI586980,2018,ACRE-IN,D98,1,11,6,41,118,77
PI437711B,2018,ACRE-IN,D99,1,12,6,45,127,82
PI515961,2019,ACRE-IN,140,1,11,12,48,135,87
PI590932,2019,ACRE-IN,106,1,3,10,45,134,89
PI515961,2019,ACRE-IN,427,2,2,8,48,134,86
PI590932,2019,ACRE-IN,601,2,9,21,44,133,89
PI548339,2019,ACRE-IN,96,1,10,9,46,133,87
PI606748,2019,ACRE-IN,678,2,10,27,43,132,89
PI548555,2019,ACRE-IN,182,1,2,15,44,132,88
PI606749,2019,ACRE-IN,679,2,9,27,45,132,87
PI556889,2019,ACRE-IN,344,1,7,28,48,132,84
PI556889,2019,ACRE-IN,572,2,12,19,48,132,84
PI548250,2019,ACRE-IN,124,1,8,11,49,132,83
PI548250,2019,ACRE-IN,498,2,8,13,49,132,83
PI642055,2019,ACRE-IN,222,1,14,19,50,132,82
PI636696,2019,ACRE-IN,440,2,14,9,51,132,81
PI636696,2019,ACRE-IN,41,1,13,5,52,132,80
PI576166,2019,ACRE-IN,596,2,14,21,43,129,86
PI438357B,2019,ACRE-IN,190,1,9,16,44,129,85
PI560206,2019,ACRE-IN,579,2,5,19,45,129,84
PI567527,2019,ACRE-IN,588,2,7,20,46,129,83
PI248402,2019,ACRE-IN,358,2,11,2,48,129,81
PI642055,2019,ACRE-IN,381,2,8,4,48,129,81
PI591490,2019,ACRE-IN,121,1,11,11,50,129,79
PI548541,2019,ACRE-IN,131,1,2,12,50,129,79
PI555399,2019,ACRE-IN,59,1,8,6,52,129,77
PI556814,2019,ACRE-IN,566,2,11,18,43,128,85
PI548602,2019,ACRE-IN,305,1,9,25,44,128,84
PI606749,2019,ACRE-IN,330,1,10,27,44,128,84
PI606748,2019,ACRE-IN,63,1,12,6,45,128,83
PI597382,2019,ACRE-IN,82,1,5,8,45,128,83
PI577798,2019,ACRE-IN,160,1,5,14,45,128,83
PI560206,2019,ACRE-IN,240,1,7,20,45,128,83
PI577798,2019,ACRE-IN,597,2,13,21,45,128,83
PI548555,2019,ACRE-IN,530,2,2,15,46,128,82
PI543793,2019,ACRE-IN,333,1,7,27,47,128,81
PI248402,2019,ACRE-IN,27,1,2,4,48,128,80
PI518668,2019,ACRE-IN,321,1,10,26,48,128,80
PI636695,2019,ACRE-IN,442,2,12,9,48,128,80
PI543793,2019,ACRE-IN,449,2,5,9,48,128,80
PI548192,2019,ACRE-IN,484,2,7,12,48,128,80
PI548193,2019,ACRE-IN,485,2,8,12,48,128,80
PI548602,2019,ACRE-IN,536,2,7,16,50,128,78
PI555399,2019,ACRE-IN,558,2,3,18,52,128,76
PI534646,2019,ACRE-IN,68,1,12,7,44,127,83
PI593256,2019,ACRE-IN,176,1,8,15,44,127,83
PI591536,2019,ACRE-IN,233,1,3,19,45,127,82
PI424159B,2019,ACRE-IN,285,1,3,23,45,127,82
PI438357B,2019,ACRE-IN,414,2,14,7,45,127,82
PI556780,2019,ACRE-IN,564,2,9,18,45,127,82
PI567767B,2019,ACRE-IN,589,2,8,20,45,127,82
PI567351B,2019,ACRE-IN,584,2,3,20,46,127,81
PI548410,2019,ACRE-IN,51,1,3,5,47,127,80
PI603205,2019,ACRE-IN,225,1,11,19,47,127,80
PI556932,2019,ACRE-IN,226,1,10,19,47,127,80
PI567527,2019,ACRE-IN,334,1,6,27,47,127,80
PI591495,2019,ACRE-IN,606,2,4,21,47,127,80
PI548603,2019,ACRE-IN,123,1,9,11,48,127,79
PI548679,2019,ACRE-IN,287,1,2,24,48,127,79
PI634763,2019,ACRE-IN,347,1,10,28,48,127,79
PI189935,2019,ACRE-IN,356,2,9,2,48,127,79
PI437711B,2019,ACRE-IN,405,2,6,6,48,127,79
PI518668,2019,ACRE-IN,429,2,4,8,48,127,79
PI548598,2019,ACRE-IN,535,2,6,16,48,127,79
PI560207,2019,ACRE-IN,580,2,4,19,48,127,79
PI634763,2019,ACRE-IN,665,2,6,26,48,127,79
PI603454,2019,ACRE-IN,669,2,10,26,48,127,79
PI591494,2019,ACRE-IN,198,1,12,17,49,127,78
PI591490,2019,ACRE-IN,602,2,8,21,50,127,77
PI603564A,2019,ACRE-IN,335,1,5,27,51,127,76
PI548541,2019,ACRE-IN,525,2,7,15,52,127,75
PI603564B,2019,ACRE-IN,671,2,12,26,52,127,75
PI424405A,2019,ACRE-IN,12,1,13,2,43,126,83
PI556814,2019,ACRE-IN,91,1,14,8,43,126,83
PI614153,2019,ACRE-IN,186,1,5,16,43,126,83
PI556781,2019,ACRE-IN,565,2,10,18,43,126,83
PI556928,2019,ACRE-IN,573,2,11,19,43,126,83
PI591497,2019,ACRE-IN,607,2,3,21,43,126,83
PI603571B,2019,ACRE-IN,166,1,11,14,44,126,82
PI574541,2019,ACRE-IN,201,1,9,17,44,126,82
PI525454,2019,ACRE-IN,56,1,5,6,45,126,81
PI591497,2019,ACRE-IN,67,1,13,7,45,126,81
PI603454,2019,ACRE-IN,122,1,10,11,45,126,81
PI556859,2019,ACRE-IN,126,1,6,11,45,126,81
PI568245,2019,ACRE-IN,161,1,6,14,45,126,81
PI556778,2019,ACRE-IN,200,1,10,17,45,126,81
PI576166,2019,ACRE-IN,230,1,6,19,45,126,81
PI591509,2019,ACRE-IN,231,1,5,19,45,126,81
PI591519,2019,ACRE-IN,261,1,2,22,45,126,81
PI591537,2019,ACRE-IN,332,1,8,27,45,126,81
PI525454,2019,ACRE-IN,432,2,7,8,45,126,81
PI542043,2019,ACRE-IN,444,2,10,9,45,126,81
PI593256,2019,ACRE-IN,643,2,10,24,45,126,81
PI597382,2019,ACRE-IN,652,2,10,25,45,126,81
PI633729,2019,ACRE-IN,691,2,6,28,45,126,81
PI437367,2019,ACRE-IN,112,1,9,10,46,126,80
PI548297,2019,ACRE-IN,505,2,2,14,46,126,80
PI547802,2019,ACRE-IN,17,1,11,3,47,126,79
PI548636,2019,ACRE-IN,170,1,14,15,47,126,79
PI548546,2019,ACRE-IN,244,1,11,20,47,126,79
PI538401B,2019,ACRE-IN,245,1,12,20,47,126,79
PI548191,2019,ACRE-IN,250,1,12,21,47,126,79
PI437388,2019,ACRE-IN,284,1,4,23,47,126,79
PI560207,2019,ACRE-IN,128,1,4,11,48,126,78
PI603564C,2019,ACRE-IN,209,1,2,18,48,126,78
PI602450,2019,ACRE-IN,259,1,3,21,48,126,78
PI547598,2019,ACRE-IN,286,1,2,23,48,126,78
PI404173B,2019,ACRE-IN,365,2,11,3,48,126,78
PI432359,2019,ACRE-IN,373,2,3,3,48,126,78
PI548194,2019,ACRE-IN,486,2,9,12,48,126,78
PI603205,2019,ACRE-IN,663,2,4,26,48,126,78
PI634761,2019,ACRE-IN,694,2,9,28,48,126,78
PI636695,2019,ACRE-IN,37,1,12,4,49,126,77
PI404173B,2019,ACRE-IN,173,1,11,15,49,126,77
PI567366A,2019,ACRE-IN,252,1,10,21,49,126,77
PI591495,2019,ACRE-IN,72,1,8,7,50,126,76
PI603564A,2019,ACRE-IN,670,2,11,26,52,126,74
PI593258,2019,ACRE-IN,83,1,6,8,43,125,82
PI540555,2019,ACRE-IN,443,2,11,9,43,125,82
PI548262,2019,ACRE-IN,501,2,5,13,43,125,82
PI556857,2019,ACRE-IN,568,2,13,18,43,125,82
PI610670,2019,ACRE-IN,680,2,8,27,43,125,82
PI633732,2019,ACRE-IN,692,2,7,28,43,125,82
PI636464,2019,ACRE-IN,52,1,2,5,44,125,81
PI540555,2019,ACRE-IN,58,1,7,6,44,125,81
PI633729,2019,ACRE-IN,73,1,7,7,44,125,81
PI438500,2019,ACRE-IN,86,1,9,8,44,125,81
PI548652,2019,ACRE-IN,120,1,12,11,44,125,81
PI591530,2019,ACRE-IN,151,1,7,13,44,125,81
PI547869,2019,ACRE-IN,155,1,3,13,44,125,81
PI542711,2019,ACRE-IN,213,1,6,18,44,125,81
PI548286,2019,ACRE-IN,504,2,2,13,44,125,81
PI556572,2019,ACRE-IN,35,1,10,4,45,125,80
PI591516,2019,ACRE-IN,53,1,2,6,45,125,80
PI615556,2019,ACRE-IN,88,1,11,8,45,125,80
PI555396,2019,ACRE-IN,108,1,5,10,45,125,80
PI432359,2019,ACRE-IN,142,1,13,12,45,125,80
PI567767B,2019,ACRE-IN,146,1,12,13,45,125,80
PI603915D,2019,ACRE-IN,215,1,8,18,45,125,80
PI591513,2019,ACRE-IN,218,1,11,18,45,125,80
PI548253,2019,ACRE-IN,499,2,7,13,45,125,80
PI603915D,2019,ACRE-IN,677,2,11,27,45,125,80
PI533654,2019,ACRE-IN,89,1,12,8,46,125,79
PI548532,2019,ACRE-IN,97,1,9,9,46,125,79
PI253660A,2019,ACRE-IN,212,1,5,18,46,125,79
PI548678,2019,ACRE-IN,273,1,14,22,46,125,79
PI548275,2019,ACRE-IN,503,2,3,13,46,125,79
PI614155,2019,ACRE-IN,686,2,2,27,46,125,79
PI591505,2019,ACRE-IN,19,1,9,3,47,125,78
PI556780,2019,ACRE-IN,33,1,8,4,47,125,78
PI547657,2019,ACRE-IN,45,1,9,5,47,125,78
PI603193,2019,ACRE-IN,71,1,9,7,47,125,78
PI602449,2019,ACRE-IN,75,1,5,7,47,125,78
PI634765,2019,ACRE-IN,99,1,7,9,47,125,78
PI591493,2019,ACRE-IN,171,1,13,15,47,125,78
PI548275,2019,ACRE-IN,220,1,13,18,47,125,78
PI547617,2019,ACRE-IN,224,1,12,19,47,125,78
PI547477,2019,ACRE-IN,451,2,3,9,47,125,78
PI548192,2019,ACRE-IN,29,1,4,4,48,125,77
PI603428D,2019,ACRE-IN,93,1,13,9,48,125,77
PI547477,2019,ACRE-IN,141,1,12,12,48,125,77
PI424405B,2019,ACRE-IN,219,1,12,18,48,125,77
PI518673,2019,ACRE-IN,341,1,4,28,48,125,77
PI424405B,2019,ACRE-IN,371,2,5,3,48,125,77
PI538401B,2019,ACRE-IN,441,2,13,9,48,125,77
PI556932,2019,ACRE-IN,575,2,9,19,48,125,77
PI603564C,2019,ACRE-IN,674,2,14,27,48,125,77
PI548267,2019,ACRE-IN,159,1,4,14,49,125,76
PI547471,2019,ACRE-IN,450,2,4,9,50,125,75
PI548267,2019,ACRE-IN,502,2,4,13,50,125,75
PI548671,2019,ACRE-IN,20,1,8,3,52,125,73
PI548671,2019,ACRE-IN,548,2,10,17,52,125,73
PI548678,2019,ACRE-IN,549,2,9,17,52,125,73
PI475822C,2019,ACRE-IN,25,1,3,3,53,125,72
PI603201,2019,ACRE-IN,31,1,6,4,54,125,71
PI548679,2019,ACRE-IN,550,2,8,17,55,125,70
PI547501,2019,ACRE-IN,145,1,13,13,42,124,82
PI438500,2019,ACRE-IN,418,2,10,7,42,124,82
PI556859,2019,ACRE-IN,569,2,14,18,43,124,81
PI612594,2019,ACRE-IN,681,2,7,27,43,124,81
PI424159B,2019,ACRE-IN,369,2,7,3,44,124,80
PI591516,2019,ACRE-IN,620,2,13,22,44,124,80
PI591518,2019,ACRE-IN,30,1,5,4,45,124,79
PI591528,2019,ACRE-IN,251,1,11,21,45,124,79
PI591521,2019,ACRE-IN,269,1,10,22,45,124,79
PI548262,2019,ACRE-IN,293,1,8,24,45,124,79
PI548598,2019,ACRE-IN,295,1,10,24,45,124,79
PI591526,2019,ACRE-IN,319,1,8,26,45,124,79
PI547847,2019,ACRE-IN,337,1,3,27,45,124,79
PI548636,2019,ACRE-IN,545,2,13,17,45,124,79
PI555396,2019,ACRE-IN,557,2,2,18,45,124,79
PI591518,2019,ACRE-IN,622,2,14,23,45,124,79
PI591519,2019,ACRE-IN,623,2,13,23,45,124,79
PI591536,2019,ACRE-IN,635,2,2,24,45,124,79
PI603571B,2019,ACRE-IN,676,2,12,27,45,124,79
PI547860,2019,ACRE-IN,471,2,9,11,46,124,78
PI615556,2019,ACRE-IN,690,2,5,28,46,124,78
PI547879,2019,ACRE-IN,185,1,4,16,47,124,77
PI547545,2019,ACRE-IN,38,1,13,4,48,124,76
PI371611,2019,ACRE-IN,363,2,13,3,48,124,76
PI547545,2019,ACRE-IN,456,2,5,10,48,124,76
PI548547,2019,ACRE-IN,528,2,4,15,48,124,76
PI634765,2019,ACRE-IN,675,2,13,27,48,124,76
PI603564B,2019,ACRE-IN,137,1,8,12,49,124,75
PI567351B,2019,ACRE-IN,39,1,14,4,50,124,74
PI437367,2019,ACRE-IN,384,2,11,4,51,124,73
PI556781,2019,ACRE-IN,139,1,10,12,43,123,80
PI597387,2019,ACRE-IN,654,2,8,25,43,123,80
PI614154,2019,ACRE-IN,685,2,3,27,43,123,80
PI615555,2019,ACRE-IN,90,1,13,8,44,123,79
PI574534,2019,ACRE-IN,138,1,9,12,44,123,79
PI591538,2019,ACRE-IN,61,1,10,6,45,123,78
PI591503,2019,ACRE-IN,148,1,10,13,45,123,78
PI568245,2019,ACRE-IN,590,2,9,20,45,123,78
PI438252C,2019,ACRE-IN,55,1,4,6,46,123,77
PI591499,2019,ACRE-IN,329,1,11,27,47,123,76
PI593258,2019,ACRE-IN,644,2,11,24,42,122,80
PI534648,2019,ACRE-IN,217,1,10,18,43,122,79
PI556816,2019,ACRE-IN,241,1,8,20,43,122,79
PI547885,2019,ACRE-IN,477,2,3,11,43,122,79
PI548685,2019,ACRE-IN,1,1,2,2,44,122,78
PI591539,2019,ACRE-IN,116,1,13,10,44,122,78
PI591561,2019,ACRE-IN,156,1,2,13,44,122,78
PI437500B,2019,ACRE-IN,183,1,2,16,44,122,78
PI591504,2019,ACRE-IN,204,1,6,17,44,122,78
PI534647,2019,ACRE-IN,278,1,10,23,44,122,78
PI591515,2019,ACRE-IN,619,2,12,22,44,122,78
PI591521,2019,ACRE-IN,624,2,12,23,44,122,78
PI548242,2019,ACRE-IN,7,1,8,2,45,122,77
PI591532,2019,ACRE-IN,49,1,5,5,45,122,77
PI437444,2019,ACRE-IN,125,1,7,11,45,122,77
PI437338,2019,ACRE-IN,132,1,3,12,45,122,77
PI591507,2019,ACRE-IN,133,1,4,12,45,122,77
PI547886,2019,ACRE-IN,157,1,2,14,45,122,77
PI547814,2019,ACRE-IN,206,1,4,17,45,122,77
PI542044,2019,ACRE-IN,232,1,4,19,45,122,77
PI547860,2019,ACRE-IN,234,1,2,19,45,122,77
PI591515,2019,ACRE-IN,246,1,13,20,45,122,77
PI437464,2019,ACRE-IN,247,1,14,20,45,122,77
PI591517,2019,ACRE-IN,248,1,14,21,45,122,77
PI591535,2019,ACRE-IN,254,1,8,21,45,122,77
PI189935,2019,ACRE-IN,256,1,6,21,45,122,77
PI548253,2019,ACRE-IN,262,1,3,22,45,122,77
PI578057,2019,ACRE-IN,266,1,7,22,45,122,77
PI591512,2019,ACRE-IN,274,1,14,23,45,122,77
PI614155,2019,ACRE-IN,279,1,9,23,45,122,77
PI547885,2019,ACRE-IN,292,1,7,24,45,122,77
PI634762,2019,ACRE-IN,301,1,13,25,45,122,77
PI612594,2019,ACRE-IN,336,1,4,27,45,122,77
PI584441,2019,ACRE-IN,339,1,2,28,45,122,77
PI547869,2019,ACRE-IN,474,2,6,11,45,122,77
PI547879,2019,ACRE-IN,476,2,4,11,45,122,77
PI547886,2019,ACRE-IN,479,2,2,12,45,122,77
PI548652,2019,ACRE-IN,546,2,12,17,45,122,77
PI574541,2019,ACRE-IN,594,2,13,20,45,122,77
PI591492,2019,ACRE-IN,603,2,7,21,45,122,77
PI591513,2019,ACRE-IN,618,2,11,22,45,122,77
PI591530,2019,ACRE-IN,627,2,9,23,45,122,77
PI591531,2019,ACRE-IN,628,2,8,23,45,122,77
PI591535,2019,ACRE-IN,634,2,2,23,45,122,77
PI593463,2019,ACRE-IN,645,2,12,24,45,122,77
PI615555,2019,ACRE-IN,689,2,4,28,45,122,77
PI437459,2019,ACRE-IN,42,1,12,5,46,122,76
PI437487,2019,ACRE-IN,264,1,5,22,46,122,76
PI437459,2019,ACRE-IN,395,2,7,5,46,122,76
PI591528,2019,ACRE-IN,626,2,10,23,46,122,76
PI591537,2019,ACRE-IN,636,2,3,24,46,122,76
PI548297,2019,ACRE-IN,281,1,7,23,47,122,75
PI547847,2019,ACRE-IN,470,2,10,11,47,122,75
PI591492,2019,ACRE-IN,144,1,14,13,48,122,74
PI603188,2019,ACRE-IN,154,1,4,13,48,122,74
PI548525,2019,ACRE-IN,289,1,4,24,48,122,74
PI371611,2019,ACRE-IN,299,1,14,24,48,122,74
PI548194,2019,ACRE-IN,331,1,9,27,48,122,74
PI547598,2019,ACRE-IN,457,2,6,10,48,122,74
PI591493,2019,ACRE-IN,604,2,6,21,48,122,74
PI591494,2019,ACRE-IN,605,2,5,21,48,122,74
PI603193,2019,ACRE-IN,661,2,2,26,48,122,74
PI547471,2019,ACRE-IN,117,1,14,10,49,122,73
PI603201,2019,ACRE-IN,662,2,3,26,53,122,69
PI548231,2019,ACRE-IN,493,2,13,13,42,121,79
PI556572,2019,ACRE-IN,561,2,6,18,42,121,79
PI479740,2019,ACRE-IN,325,1,14,26,43,121,78
PI547501,2019,ACRE-IN,455,2,4,10,43,121,78
PI591526,2019,ACRE-IN,625,2,11,23,43,121,78
PI542043,2019,ACRE-IN,297,1,12,24,44,121,77
PI547864,2019,ACRE-IN,473,2,7,11,44,121,77
PI591509,2019,ACRE-IN,615,2,8,22,44,121,77
PI548549,2019,ACRE-IN,294,1,9,24,45,121,76
PI548286,2019,ACRE-IN,310,1,4,25,45,121,76
PI548585,2019,ACRE-IN,318,1,7,26,45,121,76
PI437467,2019,ACRE-IN,399,2,3,5,45,121,76
PI547655,2019,ACRE-IN,459,2,8,10,45,121,76
PI548635,2019,ACRE-IN,542,2,13,16,45,121,76
PI591503,2019,ACRE-IN,610,2,3,22,45,121,76
PI591512,2019,ACRE-IN,617,2,10,22,45,121,76
PI591517,2019,ACRE-IN,621,2,14,22,45,121,76
PI591532,2019,ACRE-IN,630,2,6,23,46,121,75
PI595754,2019,ACRE-IN,649,2,13,25,46,121,75
PI547802,2019,ACRE-IN,465,2,14,10,47,121,74
PI548546,2019,ACRE-IN,527,2,5,15,47,121,74
PI548603,2019,ACRE-IN,537,2,8,16,47,121,74
PI437487,2019,ACRE-IN,400,2,2,5,48,121,73
PI547617,2019,ACRE-IN,458,2,7,10,48,121,73
PI548191,2019,ACRE-IN,483,2,6,12,48,121,73
PI548247,2019,ACRE-IN,495,2,11,13,48,121,73
PI548682,2019,ACRE-IN,552,2,6,17,48,121,73
PI567366A,2019,ACRE-IN,586,2,5,20,48,121,73
PI634762,2019,ACRE-IN,648,2,14,25,48,121,73
PI437467,2019,ACRE-IN,306,1,8,25,49,121,72
PI633732,2019,ACRE-IN,102,1,4,9,42,120,78
PI556816,2019,ACRE-IN,567,2,12,18,42,120,78
PI209331,2019,ACRE-IN,357,2,10,2,43,120,77
PI424405A,2019,ACRE-IN,370,2,6,3,43,120,77
PI534646,2019,ACRE-IN,435,2,10,8,43,120,77
PI534648,2019,ACRE-IN,439,2,14,8,43,120,77
PI556931,2019,ACRE-IN,574,2,10,19,43,120,77
PI556989,2019,ACRE-IN,576,2,8,19,43,120,77
PI574534,2019,ACRE-IN,593,2,12,20,43,120,77
PI576160,2019,ACRE-IN,595,2,14,20,43,120,77
PI612750,2019,ACRE-IN,682,2,6,27,43,120,77
PI597387,2019,ACRE-IN,10,1,11,2,44,120,76
PI548174,2019,ACRE-IN,135,1,6,12,44,120,76
PI556857,2019,ACRE-IN,304,1,10,25,44,120,76
PI593463,2019,ACRE-IN,309,1,5,25,44,120,76
PI591533,2019,ACRE-IN,631,2,5,23,44,120,76
PI437391,2019,ACRE-IN,388,2,14,5,45,120,75
PI437464,2019,ACRE-IN,398,2,4,5,45,120,75
PI437894,2019,ACRE-IN,406,2,7,6,45,120,75
PI475822C,2019,ACRE-IN,420,2,8,7,45,120,75
PI542044,2019,ACRE-IN,445,2,9,9,45,120,75
PI542711,2019,ACRE-IN,447,2,7,9,45,120,75
PI636464,2019,ACRE-IN,448,2,6,9,45,120,75
PI547657,2019,ACRE-IN,460,2,9,10,45,120,75
PI548174,2019,ACRE-IN,480,2,3,12,45,120,75
PI548549,2019,ACRE-IN,529,2,3,15,45,120,75
PI548585,2019,ACRE-IN,533,2,4,16,45,120,75
PI548670,2019,ACRE-IN,547,2,11,17,45,120,75
PI556778,2019,ACRE-IN,563,2,8,18,45,120,75
PI574532,2019,ACRE-IN,592,2,11,20,45,120,75
PI584441,2019,ACRE-IN,599,2,11,21,45,120,75
PI591504,2019,ACRE-IN,611,2,4,22,45,120,75
PI591505,2019,ACRE-IN,612,2,5,22,45,120,75
PI591506,2019,ACRE-IN,613,2,6,22,45,120,75
PI591538,2019,ACRE-IN,637,2,4,24,45,120,75
PI591539,2019,ACRE-IN,638,2,5,24,45,120,75
PI591540,2019,ACRE-IN,639,2,6,24,45,120,75
PI591561,2019,ACRE-IN,640,2,7,24,45,120,75
PI547500,2019,ACRE-IN,84,1,7,8,46,120,74
PI518673,2019,ACRE-IN,430,2,5,8,46,120,74
PI533654,2019,ACRE-IN,433,2,8,8,46,120,74
PI547484,2019,ACRE-IN,452,2,2,9,46,120,74
PI547497,2019,ACRE-IN,453,2,2,10,46,120,74
PI548339,2019,ACRE-IN,508,2,5,14,46,120,74
PI591507,2019,ACRE-IN,614,2,7,22,46,120,74
PI602449,2019,ACRE-IN,657,2,5,25,46,120,74
PI547497,2019,ACRE-IN,115,1,12,10,47,120,73
PI437903,2019,ACRE-IN,408,2,9,6,47,120,73
PI548242,2019,ACRE-IN,494,2,12,13,47,120,73
PI438486,2019,ACRE-IN,4,1,5,2,48,120,72
PI591506,2019,ACRE-IN,308,1,6,25,48,120,72
PI547655,2019,ACRE-IN,326,1,14,27,48,120,72
PI437338,2019,ACRE-IN,377,2,4,4,48,120,72
PI437388,2019,ACRE-IN,387,2,14,4,48,120,72
PI437461,2019,ACRE-IN,396,2,6,5,48,120,72
PI438252C,2019,ACRE-IN,411,2,12,6,48,120,72
PI547500,2019,ACRE-IN,454,2,3,10,48,120,72
PI548177,2019,ACRE-IN,481,2,4,12,48,120,72
PI548532,2019,ACRE-IN,524,2,8,15,48,120,72
PI578057,2019,ACRE-IN,598,2,12,21,48,120,72
PI602450,2019,ACRE-IN,658,2,4,25,48,120,72
PI603188,2019,ACRE-IN,660,2,2,25,48,120,72
PI479740,2019,ACRE-IN,421,2,7,7,42,119,77
PI556511,2019,ACRE-IN,560,2,5,18,42,119,77
PI548340,2019,ACRE-IN,191,1,10,16,43,119,76
PI595363,2019,ACRE-IN,255,1,7,21,43,119,76
PI189928,2019,ACRE-IN,271,1,12,22,43,119,76
PI548365,2019,ACRE-IN,280,1,8,23,43,119,76
PI548614,2019,ACRE-IN,539,2,10,16,43,119,76
PI548685,2019,ACRE-IN,554,2,4,17,43,119,76
PI556687,2019,ACRE-IN,562,2,7,18,43,119,76
PI593654,2019,ACRE-IN,646,2,13,24,43,119,76
PI614153,2019,ACRE-IN,684,2,4,27,43,119,76
PI548421,2019,ACRE-IN,119,1,13,11,44,119,75
PI595754,2019,ACRE-IN,152,1,6,13,44,119,75
PI438079,2019,ACRE-IN,167,1,12,14,44,119,75
PI576160,2019,ACRE-IN,214,1,7,18,44,119,75
PI542709,2019,ACRE-IN,3,1,4,2,45,119,74
PI591533,2019,ACRE-IN,21,1,7,3,45,119,74
PI548247,2019,ACRE-IN,47,1,7,5,45,119,74
PI591540,2019,ACRE-IN,153,1,5,13,45,119,74
PI591531,2019,ACRE-IN,238,1,5,20,45,119,74
PI547484,2019,ACRE-IN,268,1,9,22,45,119,74
PI548635,2019,ACRE-IN,272,1,13,22,45,119,74
PI548383,2019,ACRE-IN,323,1,12,26,45,119,74
PI437550C,2019,ACRE-IN,403,2,4,6,45,119,74
PI596407,2019,ACRE-IN,651,2,11,25,45,119,74
PI614832,2019,ACRE-IN,687,2,2,28,45,119,74
PI548542,2019,ACRE-IN,62,1,11,6,46,119,73
PI603186,2019,ACRE-IN,103,1,3,9,46,119,73
PI547663,2019,ACRE-IN,114,1,11,10,46,119,73
PI438486,2019,ACRE-IN,417,2,11,7,46,119,73
PI591499,2019,ACRE-IN,609,2,2,22,46,119,73
PI548547,2019,ACRE-IN,15,1,13,3,47,119,72
PI438310,2019,ACRE-IN,87,1,10,8,47,119,72
PI548558,2019,ACRE-IN,163,1,8,14,47,119,72
PI437357,2019,ACRE-IN,243,1,10,20,47,119,72
PI548558,2019,ACRE-IN,531,2,2,16,47,119,72
PI567404A,2019,ACRE-IN,587,2,6,20,48,119,71
PI534645,2019,ACRE-IN,237,1,4,20,42,118,76
PI209331,2019,ACRE-IN,258,1,4,21,42,118,76
PI614154,2019,ACRE-IN,6,1,7,2,43,118,75
PI614832,2019,ACRE-IN,66,1,14,7,43,118,75
PI603434,2019,ACRE-IN,270,1,11,22,43,118,75
PI153292,2019,ACRE-IN,350,2,3,2,43,118,75
PI518663,2019,ACRE-IN,428,2,3,8,43,118,75
PI518675,2019,ACRE-IN,431,2,6,8,43,118,75
PI534645,2019,ACRE-IN,434,2,9,8,43,118,75
PI153243,2019,ACRE-IN,349,2,2,2,44,118,74
PI596407,2019,ACRE-IN,22,1,6,3,45,118,73
PI547813,2019,ACRE-IN,46,1,8,5,45,118,73
PI548682,2019,ACRE-IN,64,1,13,6,45,118,73
PI548517,2019,ACRE-IN,85,1,8,8,45,118,73
PI437903,2019,ACRE-IN,235,1,2,20,45,118,73
PI370055,2019,ACRE-IN,291,1,6,24,45,118,73
PI556989,2019,ACRE-IN,315,1,4,26,45,118,73
PI438079,2019,ACRE-IN,409,2,10,6,45,118,73
PI547663,2019,ACRE-IN,461,2,10,10,45,118,73
PI548410,2019,ACRE-IN,517,2,14,14,45,118,73
PI591510,2019,ACRE-IN,591,2,10,20,45,118,73
PI592946,2019,ACRE-IN,641,2,8,24,45,118,73
PI603434,2019,ACRE-IN,667,2,8,26,45,118,73
PI547801,2019,ACRE-IN,195,1,14,16,46,118,72
PI634761,2019,ACRE-IN,34,1,9,4,47,118,71
PI591498,2019,ACRE-IN,221,1,14,18,47,118,71
PI437711B,2019,ACRE-IN,32,1,7,4,48,118,70
PI189926,2019,ACRE-IN,343,1,6,28,48,118,70
PI437461,2019,ACRE-IN,348,1,11,28,48,118,70
PI283331,2019,ACRE-IN,361,2,14,2,48,118,70
PI417573,2019,ACRE-IN,368,2,8,3,48,118,70
PI427136,2019,ACRE-IN,372,2,4,3,48,118,70
PI548542,2019,ACRE-IN,526,2,6,15,48,118,70
PI603428D,2019,ACRE-IN,666,2,7,26,48,118,70
PI634764,2019,ACRE-IN,673,2,14,26,48,118,70
PI556931,2019,ACRE-IN,5,1,6,2,43,117,74
PI561321,2019,ACRE-IN,57,1,6,6,43,117,74
PI475822B,2019,ACRE-IN,74,1,6,7,43,117,74
PI556511,2019,ACRE-IN,110,1,7,10,43,117,74
PI595926,2019,ACRE-IN,149,1,9,13,43,117,74
PI552538,2019,ACRE-IN,275,1,13,23,43,117,74
PI534647,2019,ACRE-IN,436,2,11,8,43,117,74
PI547798,2019,ACRE-IN,462,2,11,10,43,117,74
PI612932,2019,ACRE-IN,683,2,5,27,43,117,74
PI591534,2019,ACRE-IN,14,1,14,3,44,117,73
PI574532,2019,ACRE-IN,79,1,2,8,44,117,73
PI591510,2019,ACRE-IN,194,1,13,16,44,117,73
PI548614,2019,ACRE-IN,227,1,9,19,44,117,73
PI548365,2019,ACRE-IN,510,2,7,14,44,117,73
PI437894,2019,ACRE-IN,65,1,14,6,45,117,72
PI548633,2019,ACRE-IN,76,1,4,7,45,117,72
PI438124B,2019,ACRE-IN,113,1,10,10,45,117,72
PI610670,2019,ACRE-IN,283,1,5,23,45,117,72
PI507708,2019,ACRE-IN,426,2,2,7,45,117,72
PI548421,2019,ACRE-IN,519,2,13,15,45,117,72
PI591498,2019,ACRE-IN,608,2,2,21,45,117,72
PI564718,2019,ACRE-IN,583,2,2,20,46,117,71
PI283331,2019,ACRE-IN,187,1,6,16,47,117,70
PI592946,2019,ACRE-IN,223,1,13,19,47,117,70
PI437103,2019,ACRE-IN,378,2,5,4,47,117,70
PI548383,2019,ACRE-IN,515,2,12,14,47,117,70
PI437377,2019,ACRE-IN,196,1,14,17,48,117,69
PI603396,2019,ACRE-IN,328,1,12,27,48,117,69
PI437444,2019,ACRE-IN,394,2,8,5,48,117,69
PI603186,2019,ACRE-IN,659,2,3,25,48,117,69
PI556687,2019,ACRE-IN,208,1,2,17,42,116,74
PI518675,2019,ACRE-IN,118,1,14,11,43,116,73
PI548597,2019,ACRE-IN,192,1,11,16,43,116,73
PI518663,2019,ACRE-IN,316,1,5,26,43,116,73
PI548613,2019,ACRE-IN,327,1,13,27,43,116,73
PI586980,2019,ACRE-IN,600,2,10,21,43,116,73
PI591534,2019,ACRE-IN,632,2,4,23,43,116,73
PI548684,2019,ACRE-IN,228,1,8,19,44,116,72
PI634764,2019,ACRE-IN,307,1,7,25,44,116,72
PI548632,2019,ACRE-IN,312,1,2,25,44,116,72
PI189928,2019,ACRE-IN,355,2,8,2,44,116,72
PI437500B,2019,ACRE-IN,401,2,2,6,44,116,72
PI437397,2019,ACRE-IN,257,1,5,21,45,116,71
PI548373,2019,ACRE-IN,296,1,11,24,45,116,71
PI547800,2019,ACRE-IN,463,2,12,10,45,116,71
PI417526,2019,ACRE-IN,366,2,10,3,46,116,70
PI547800,2019,ACRE-IN,207,1,3,17,47,116,69
PI548632,2019,ACRE-IN,540,2,11,16,47,116,69
PI548204,2019,ACRE-IN,490,2,13,12,48,116,68
PI603442,2019,ACRE-IN,28,1,3,4,42,115,73
PI438341,2019,ACRE-IN,95,1,11,9,42,115,73
PI561321,2019,ACRE-IN,581,2,3,19,42,115,73
PI593654,2019,ACRE-IN,48,1,6,5,43,115,72
PI153292,2019,ACRE-IN,69,1,11,7,43,115,72
PI437392,2019,ACRE-IN,105,1,2,10,43,115,72
PI548231,2019,ACRE-IN,174,1,10,15,43,115,72
PI475822B,2019,ACRE-IN,419,2,9,7,43,115,72
PI595363,2019,ACRE-IN,647,2,14,24,43,115,72
PI595926,2019,ACRE-IN,650,2,12,25,43,115,72
PI612932,2019,ACRE-IN,16,1,12,3,44,115,71
PI548686,2019,ACRE-IN,104,1,2,9,44,115,71
PI548518,2019,ACRE-IN,130,1,2,11,44,115,71
PI548304,2019,ACRE-IN,164,1,9,14,44,115,71
PI417526,2019,ACRE-IN,178,1,6,15,44,115,71
PI586980,2019,ACRE-IN,180,1,4,15,44,115,71
PI370055,2019,ACRE-IN,362,2,14,2,44,115,71
PI438341,2019,ACRE-IN,413,2,14,6,44,115,71
PI437550C,2019,ACRE-IN,43,1,11,5,45,115,70
PI548180,2019,ACRE-IN,70,1,10,7,45,115,70
PI507708,2019,ACRE-IN,80,1,3,8,45,115,70
PI507692B,2019,ACRE-IN,107,1,4,10,45,115,70
PI437365,2019,ACRE-IN,111,1,8,10,45,115,70
PI564718,2019,ACRE-IN,129,1,3,11,45,115,70
PI170380,2019,ACRE-IN,351,2,4,2,45,115,70
PI253660A,2019,ACRE-IN,359,2,12,2,45,115,70
PI437124,2019,ACRE-IN,375,2,2,4,45,115,70
PI437357,2019,ACRE-IN,380,2,7,4,45,115,70
PI437641B,2019,ACRE-IN,404,2,5,6,45,115,70
PI438124B,2019,ACRE-IN,410,2,11,6,45,115,70
PI507692B,2019,ACRE-IN,423,2,5,7,45,115,70
PI542709,2019,ACRE-IN,446,2,8,9,45,115,70
PI548340,2019,ACRE-IN,466,2,14,11,45,115,70
PI547813,2019,ACRE-IN,468,2,12,11,45,115,70
PI547814,2019,ACRE-IN,469,2,11,11,45,115,70
PI548518,2019,ACRE-IN,521,2,11,15,45,115,70
PI548684,2019,ACRE-IN,553,2,5,17,45,115,70
PI170380,2019,ACRE-IN,181,1,3,15,47,115,68
PI548373,2019,ACRE-IN,513,2,10,14,47,115,68
PI548633,2019,ACRE-IN,541,2,12,16,47,115,68
PI437422,2019,ACRE-IN,23,1,5,3,48,115,67
PI548177,2019,ACRE-IN,162,1,7,14,48,115,67
PI547801,2019,ACRE-IN,464,2,13,10,48,115,67
PI548517,2019,ACRE-IN,520,2,12,15,48,115,67
PI548525,2019,ACRE-IN,523,2,9,15,48,115,67
PI603396,2019,ACRE-IN,664,2,5,26,48,115,67
PI437103,2019,ACRE-IN,81,1,4,8,50,115,65
PI552538,2019,ACRE-IN,556,2,2,17,NA,115,78
PI548613,2019,ACRE-IN,538,2,9,16,42,114,72
PI437317,2019,ACRE-IN,376,2,3,4,43,114,71
PI437392,2019,ACRE-IN,389,2,13,5,43,114,71
PI548367,2019,ACRE-IN,512,2,9,14,43,114,71
PI547811,2019,ACRE-IN,467,2,13,11,44,114,70
PI548304,2019,ACRE-IN,506,2,3,14,45,114,69
PI548686,2019,ACRE-IN,555,2,3,17,45,114,69
PI548180,2019,ACRE-IN,482,2,5,12,46,114,68
PI438310,2019,ACRE-IN,412,2,13,6,47,114,67
PI507676,2019,ACRE-IN,422,2,6,7,47,114,67
PI253661B,2019,ACRE-IN,314,1,3,26,48,114,66
PI253661B,2019,ACRE-IN,360,2,13,2,48,114,66
PI437422,2019,ACRE-IN,393,2,9,5,48,114,66
PI189926,2019,ACRE-IN,354,2,7,2,49,114,65
PI437412,2019,ACRE-IN,199,1,11,17,43,113,70
PI612750,2019,ACRE-IN,202,1,8,17,43,113,70
PI437463B,2019,ACRE-IN,397,2,5,5,43,113,70
PI548597,2019,ACRE-IN,534,2,5,16,43,113,70
PI547798,2019,ACRE-IN,101,1,5,9,44,113,69
PI437500C,2019,ACRE-IN,169,1,14,14,44,113,69
PI437124,2019,ACRE-IN,197,1,13,17,44,113,69
PI547811,2019,ACRE-IN,203,1,7,17,44,113,69
PI548366,2019,ACRE-IN,165,1,10,14,45,113,68
PI438409,2019,ACRE-IN,216,1,9,18,45,113,68
PI561330A,2019,ACRE-IN,239,1,6,20,45,113,68
PI548366,2019,ACRE-IN,511,2,8,14,45,113,68
PI398881,2019,ACRE-IN,44,1,10,5,46,113,67
PI437397,2019,ACRE-IN,391,2,11,5,47,113,66
PI548204,2019,ACRE-IN,60,1,9,6,48,113,65
PI603442,2019,ACRE-IN,668,2,9,26,42,112,70
PI437500C,2019,ACRE-IN,402,2,3,6,43,112,69
PI561330A,2019,ACRE-IN,582,2,2,19,43,112,69
PI437365,2019,ACRE-IN,383,2,10,4,45,112,67
PI398881,2019,ACRE-IN,364,2,12,3,47,112,65
PI437377,2019,ACRE-IN,385,2,12,4,49,112,63
PI548381,2019,ACRE-IN,514,2,11,14,43,111,68
PI548562,2019,ACRE-IN,532,2,3,16,43,111,68
PI548562,2019,ACRE-IN,92,1,14,9,44,111,67
PI437641B,2019,ACRE-IN,11,1,12,2,45,111,66
PI437412,2019,ACRE-IN,392,2,10,5,45,111,66
PI507676,2019,ACRE-IN,172,1,12,15,46,111,65
PI438409,2019,ACRE-IN,416,2,12,7,48,111,63
PI548381,2019,ACRE-IN,100,1,6,9,43,110,67
PI437317,2019,ACRE-IN,9,1,10,2,44,110,66
PI437463B,2019,ACRE-IN,313,1,2,26,45,110,65
PI427136,2019,ACRE-IN,302,1,12,25,45,NA,NA
PI548193,2019,ACRE-IN,290,1,5,24,48,NA,NA
PI437391,2019,ACRE-IN,300,1,14,25,48,NA,NA
PI567404A,2019,ACRE-IN,298,1,13,24,NA,NA,NA
PI606748,2019,ROMNEY-IN,480,2,3,12,42,129,87
PI515961,2019,ROMNEY-IN,602,2,8,21,44,129,85
PI538401B,2019,ROMNEY-IN,387,2,14,4,45,129,84
PI548603,2019,ROMNEY-IN,428,2,3,8,48,129,81
PI438357B,2019,ROMNEY-IN,398,2,4,5,44,128,84
PI556889,2019,ROMNEY-IN,467,2,13,11,44,128,84
PI636696,2019,ROMNEY-IN,324,1,13,26,48,128,80
PI518668,2019,ROMNEY-IN,489,2,12,12,48,128,80
PI548602,2019,ROMNEY-IN,408,2,9,6,50,128,78
PI591495,2019,ROMNEY-IN,506,2,3,14,50,128,78
PI560206,2019,ROMNEY-IN,397,2,5,5,44,127,83
PI548541,2019,ROMNEY-IN,452,2,2,9,44,127,83
PI548250,2019,ROMNEY-IN,662,2,3,26,48,127,79
PI593258,2019,ROMNEY-IN,60,1,9,6,42,126,84
PI547864,2019,ROMNEY-IN,199,1,11,17,42,126,84
PI556857,2019,ROMNEY-IN,356,2,9,2,42,126,84
PI548340,2019,ROMNEY-IN,85,1,8,8,44,126,82
PI556687,2019,ROMNEY-IN,87,1,10,8,42,125,83
PI515961,2019,ROMNEY-IN,136,1,7,12,43,125,82
PI606748,2019,ROMNEY-IN,246,1,13,20,43,125,82
PI437357,2019,ROMNEY-IN,239,1,6,20,46,125,79
PI560206,2019,ROMNEY-IN,158,1,3,14,48,125,77
PI525454,2019,ROMNEY-IN,117,1,14,10,42,124,82
PI597387,2019,ROMNEY-IN,42,1,12,5,43,124,81
PI606749,2019,ROMNEY-IN,95,1,11,9,43,124,81
PI548555,2019,ROMNEY-IN,129,1,3,11,43,124,81
PI591530,2019,ROMNEY-IN,148,1,10,13,43,124,81
PI576166,2019,ROMNEY-IN,233,1,3,19,43,124,81
PI593256,2019,ROMNEY-IN,297,1,12,24,43,124,81
PI540555,2019,ROMNEY-IN,298,1,13,24,43,124,81
PI548562,2019,ROMNEY-IN,316,1,5,26,43,124,81
PI614155,2019,ROMNEY-IN,323,1,12,26,43,124,81
PI556859,2019,ROMNEY-IN,484,2,7,12,43,124,81
PI556889,2019,ROMNEY-IN,57,1,6,6,44,124,80
PI547655,2019,ROMNEY-IN,96,1,10,9,44,124,80
PI574541,2019,ROMNEY-IN,99,1,7,9,44,124,80
PI248402,2019,ROMNEY-IN,128,1,4,11,44,124,80
PI591509,2019,ROMNEY-IN,159,1,4,14,44,124,80
PI548632,2019,ROMNEY-IN,197,1,13,17,44,124,80
PI597382,2019,ROMNEY-IN,355,2,8,2,44,124,80
PI576166,2019,ROMNEY-IN,366,2,10,3,44,124,80
PI606749,2019,ROMNEY-IN,457,2,6,10,44,124,80
PI555399,2019,ROMNEY-IN,510,2,7,14,44,124,80
PI424159B,2019,ROMNEY-IN,30,1,5,4,45,124,79
PI548682,2019,ROMNEY-IN,483,2,6,12,45,124,79
PI547477,2019,ROMNEY-IN,29,1,4,4,46,124,78
PI615556,2019,ROMNEY-IN,154,1,4,13,47,124,77
PI602449,2019,ROMNEY-IN,208,1,2,17,47,124,77
PI636695,2019,ROMNEY-IN,325,1,14,26,47,124,77
PI548250,2019,ROMNEY-IN,326,1,14,27,47,124,77
PI548541,2019,ROMNEY-IN,110,1,7,10,48,124,76
PI591495,2019,ROMNEY-IN,112,1,9,10,48,124,76
PI548679,2019,ROMNEY-IN,172,1,12,15,48,124,76
PI548598,2019,ROMNEY-IN,155,1,3,13,49,124,75
PI591490,2019,ROMNEY-IN,216,1,9,18,49,124,75
PI548193,2019,ROMNEY-IN,32,1,7,4,50,124,74
PI547879,2019,ROMNEY-IN,156,1,2,13,50,124,74
PI603564B,2019,ROMNEY-IN,47,1,7,5,51,124,73
PI548602,2019,ROMNEY-IN,165,1,10,14,52,124,72
PI555399,2019,ROMNEY-IN,226,1,10,19,52,124,72
PI556932,2019,ROMNEY-IN,544,2,14,17,42,123,81
PI437367,2019,ROMNEY-IN,35,1,10,4,43,123,80
PI518675,2019,ROMNEY-IN,44,1,10,5,43,123,80
PI548286,2019,ROMNEY-IN,203,1,7,17,43,123,80
PI548555,2019,ROMNEY-IN,661,2,2,26,43,123,80
PI603454,2019,ROMNEY-IN,50,1,4,5,44,123,79
PI567527,2019,ROMNEY-IN,133,1,4,12,44,123,79
PI591513,2019,ROMNEY-IN,281,1,7,23,44,123,79
PI591498,2019,ROMNEY-IN,493,2,13,13,44,123,79
PI602449,2019,ROMNEY-IN,519,2,13,15,44,123,79
PI548679,2019,ROMNEY-IN,577,2,7,19,44,123,79
PI548636,2019,ROMNEY-IN,611,2,4,22,44,123,79
PI590932,2019,ROMNEY-IN,624,2,12,23,44,123,79
PI567527,2019,ROMNEY-IN,688,2,3,28,44,123,79
PI590932,2019,ROMNEY-IN,55,1,4,6,45,123,78
PI432359,2019,ROMNEY-IN,153,1,5,13,45,123,78
PI424405B,2019,ROMNEY-IN,371,2,5,3,46,123,77
PI603564B,2019,ROMNEY-IN,564,2,9,18,46,123,77
PI548247,2019,ROMNEY-IN,283,1,5,23,47,123,76
PI560207,2019,ROMNEY-IN,671,2,12,26,47,123,76
PI543793,2019,ROMNEY-IN,282,1,6,23,48,123,75
PI591494,2019,ROMNEY-IN,304,1,10,25,48,123,75
PI560207,2019,ROMNEY-IN,310,1,4,25,48,123,75
PI518668,2019,ROMNEY-IN,77,1,3,7,49,123,74
PI642055,2019,ROMNEY-IN,551,2,7,17,49,123,74
PI636696,2019,ROMNEY-IN,678,2,10,27,49,123,74
PI548603,2019,ROMNEY-IN,80,1,3,8,50,123,73
PI642055,2019,ROMNEY-IN,84,1,7,8,50,123,73
PI556857,2019,ROMNEY-IN,190,1,9,16,42,122,80
PI556572,2019,ROMNEY-IN,292,1,7,24,42,122,80
PI542711,2019,ROMNEY-IN,295,1,10,24,42,122,80
PI614832,2019,ROMNEY-IN,449,2,5,9,42,122,80
PI593256,2019,ROMNEY-IN,613,2,6,22,42,122,80
PI591515,2019,ROMNEY-IN,92,1,14,9,43,122,79
PI591499,2019,ROMNEY-IN,125,1,7,11,43,122,79
PI591519,2019,ROMNEY-IN,152,1,6,13,43,122,79
PI556814,2019,ROMNEY-IN,220,1,13,18,43,122,79
PI555396,2019,ROMNEY-IN,644,2,11,24,43,122,79
PI542043,2019,ROMNEY-IN,59,1,8,6,44,122,78
PI542709,2019,ROMNEY-IN,64,1,13,6,44,122,78
PI602450,2019,ROMNEY-IN,66,1,14,7,44,122,78
PI603193,2019,ROMNEY-IN,168,1,13,14,44,122,78
PI556780,2019,ROMNEY-IN,187,1,6,16,44,122,78
PI567351B,2019,ROMNEY-IN,192,1,11,16,44,122,78
PI591536,2019,ROMNEY-IN,399,2,3,5,44,122,78
PI547879,2019,ROMNEY-IN,406,2,7,6,44,122,78
PI556814,2019,ROMNEY-IN,505,2,2,14,44,122,78
PI577798,2019,ROMNEY-IN,618,2,11,22,44,122,78
PI636695,2019,ROMNEY-IN,646,2,13,24,44,122,78
PI548532,2019,ROMNEY-IN,359,2,12,2,45,122,77
PI543793,2019,ROMNEY-IN,649,2,13,25,45,122,77
PI437391,2019,ROMNEY-IN,166,1,11,14,46,122,76
PI591493,2019,ROMNEY-IN,19,1,9,3,48,122,74
PI634763,2019,ROMNEY-IN,25,1,3,3,48,122,74
PI548267,2019,ROMNEY-IN,131,1,2,12,48,122,74
PI556932,2019,ROMNEY-IN,200,1,10,17,48,122,74
PI248402,2019,ROMNEY-IN,502,2,4,13,48,122,74
PI591490,2019,ROMNEY-IN,645,2,12,24,49,122,73
PI548532,2019,ROMNEY-IN,3,1,4,2,50,122,72
PI548546,2019,ROMNEY-IN,285,1,3,23,50,122,72
PI548547,2019,ROMNEY-IN,312,1,2,25,50,122,72
PI538401B,2019,ROMNEY-IN,318,1,7,26,50,122,72
PI548678,2019,ROMNEY-IN,13,1,14,2,53,122,69
PI603201,2019,ROMNEY-IN,228,1,8,19,53,122,69
PI556989,2019,ROMNEY-IN,22,1,6,3,42,121,79
PI424405B,2019,ROMNEY-IN,121,1,11,11,42,121,79
PI548652,2019,ROMNEY-IN,290,1,5,24,42,121,79
PI548253,2019,ROMNEY-IN,350,2,3,2,42,121,79
PI614153,2019,ROMNEY-IN,568,2,13,18,42,121,79
PI542043,2019,ROMNEY-IN,693,2,8,28,42,121,79
PI614153,2019,ROMNEY-IN,7,1,8,2,43,121,78
PI576160,2019,ROMNEY-IN,219,1,12,18,43,121,78
PI591516,2019,ROMNEY-IN,256,1,6,21,43,121,78
PI209331,2019,ROMNEY-IN,403,2,4,6,43,121,78
PI614155,2019,ROMNEY-IN,409,2,10,6,43,121,78
PI634763,2019,ROMNEY-IN,417,2,11,7,43,121,78
PI591532,2019,ROMNEY-IN,419,2,9,7,43,121,78
PI548262,2019,ROMNEY-IN,442,2,12,9,43,121,78
PI567767B,2019,ROMNEY-IN,450,2,4,9,43,121,78
PI612594,2019,ROMNEY-IN,504,2,2,13,43,121,78
PI591509,2019,ROMNEY-IN,610,2,3,22,43,121,78
PI556781,2019,ROMNEY-IN,617,2,10,22,43,121,78
PI615556,2019,ROMNEY-IN,639,2,6,24,43,121,78
PI548177,2019,ROMNEY-IN,16,1,12,3,44,121,77
PI595754,2019,ROMNEY-IN,72,1,8,7,44,121,77
PI603571B,2019,ROMNEY-IN,105,1,2,10,44,121,77
PI567767B,2019,ROMNEY-IN,124,1,8,11,44,121,77
PI591497,2019,ROMNEY-IN,202,1,8,17,44,121,77
PI634762,2019,ROMNEY-IN,241,1,8,20,44,121,77
PI591503,2019,ROMNEY-IN,258,1,4,21,44,121,77
PI591535,2019,ROMNEY-IN,376,2,3,4,44,121,77
PI591505,2019,ROMNEY-IN,395,2,7,5,44,121,77
PI547847,2019,ROMNEY-IN,437,2,12,8,44,121,77
PI547860,2019,ROMNEY-IN,491,2,14,12,44,121,77
PI548542,2019,ROMNEY-IN,507,2,4,14,44,121,77
PI591503,2019,ROMNEY-IN,509,2,6,14,44,121,77
PI548275,2019,ROMNEY-IN,515,2,12,14,44,121,77
PI591518,2019,ROMNEY-IN,518,2,14,15,44,121,77
PI591515,2019,ROMNEY-IN,520,2,12,15,44,121,77
PI548194,2019,ROMNEY-IN,529,2,3,15,44,121,77
PI542711,2019,ROMNEY-IN,532,2,3,16,44,121,77
PI591521,2019,ROMNEY-IN,534,2,5,16,44,121,77
PI548247,2019,ROMNEY-IN,536,2,7,16,44,121,77
PI556780,2019,ROMNEY-IN,548,2,10,17,44,121,77
PI591499,2019,ROMNEY-IN,569,2,14,18,44,121,77
PI437367,2019,ROMNEY-IN,592,2,11,20,44,121,77
PI603205,2019,ROMNEY-IN,622,2,14,23,44,121,77
PI548192,2019,ROMNEY-IN,643,2,10,24,44,121,77
PI548547,2019,ROMNEY-IN,648,2,14,25,44,121,77
PI548286,2019,ROMNEY-IN,654,2,8,25,44,121,77
PI525454,2019,ROMNEY-IN,665,2,6,26,44,121,77
PI556928,2019,ROMNEY-IN,666,2,7,26,44,121,77
PI548297,2019,ROMNEY-IN,675,2,13,27,44,121,77
PI602450,2019,ROMNEY-IN,686,2,2,27,44,121,77
PI591528,2019,ROMNEY-IN,63,1,12,6,45,121,76
PI577798,2019,ROMNEY-IN,270,1,11,22,45,121,76
PI189935,2019,ROMNEY-IN,272,1,13,22,45,121,76
PI547477,2019,ROMNEY-IN,375,2,2,4,45,121,76
PI547617,2019,ROMNEY-IN,389,2,13,5,45,121,76
PI547657,2019,ROMNEY-IN,438,2,13,8,45,121,76
PI547545,2019,ROMNEY-IN,633,2,3,23,45,121,76
PI591493,2019,ROMNEY-IN,655,2,7,25,45,121,76
PI568245,2019,ROMNEY-IN,79,1,2,8,46,121,75
PI189935,2019,ROMNEY-IN,425,2,3,7,46,121,75
PI547497,2019,ROMNEY-IN,566,2,11,18,46,121,75
PI548194,2019,ROMNEY-IN,175,1,9,15,47,121,74
PI548191,2019,ROMNEY-IN,603,2,7,21,47,121,74
PI547617,2019,ROMNEY-IN,49,1,5,5,48,121,73
PI591535,2019,ROMNEY-IN,78,1,2,7,48,121,73
PI634765,2019,ROMNEY-IN,150,1,8,13,48,121,73
PI427136,2019,ROMNEY-IN,232,1,4,19,48,121,73
PI591516,2019,ROMNEY-IN,565,2,10,18,48,121,73
PI634765,2019,ROMNEY-IN,607,2,3,21,48,121,73
PI371611,2019,ROMNEY-IN,230,1,6,19,49,121,72
PI567351B,2019,ROMNEY-IN,642,2,9,24,49,121,72
PI603205,2019,ROMNEY-IN,8,1,9,2,50,121,71
PI603564C,2019,ROMNEY-IN,151,1,7,13,50,121,71
PI404173B,2019,ROMNEY-IN,313,1,2,26,51,121,70
PI548678,2019,ROMNEY-IN,664,2,5,26,53,121,68
PI534645,2019,ROMNEY-IN,191,1,10,16,42,120,78
PI548635,2019,ROMNEY-IN,218,1,11,18,42,120,78
PI534646,2019,ROMNEY-IN,303,1,11,25,42,120,78
PI593463,2019,ROMNEY-IN,348,1,11,28,42,120,78
PI438500,2019,ROMNEY-IN,414,2,14,7,42,120,78
PI591518,2019,ROMNEY-IN,12,1,13,2,43,120,77
PI591504,2019,ROMNEY-IN,40,1,14,5,43,120,77
PI603915D,2019,ROMNEY-IN,41,1,13,5,43,120,77
PI547869,2019,ROMNEY-IN,82,1,5,8,43,120,77
PI548262,2019,ROMNEY-IN,169,1,14,14,43,120,77
PI591521,2019,ROMNEY-IN,280,1,8,23,43,120,77
PI534646,2019,ROMNEY-IN,386,2,13,4,43,120,77
PI432359,2019,ROMNEY-IN,627,2,9,23,43,120,77
PI548253,2019,ROMNEY-IN,15,1,13,3,44,120,76
PI556859,2019,ROMNEY-IN,24,1,4,3,44,120,76
PI189926,2019,ROMNEY-IN,37,1,12,4,44,120,76
PI533654,2019,ROMNEY-IN,61,1,10,6,44,120,76
PI547497,2019,ROMNEY-IN,67,1,13,7,44,120,76
PI548297,2019,ROMNEY-IN,123,1,9,11,44,120,76
PI547885,2019,ROMNEY-IN,266,1,7,22,44,120,76
PI547886,2019,ROMNEY-IN,277,1,11,23,44,120,76
PI584441,2019,ROMNEY-IN,383,2,10,4,44,120,76
PI593463,2019,ROMNEY-IN,461,2,10,10,44,120,76
PI548635,2019,ROMNEY-IN,514,2,11,14,44,120,76
PI424159B,2019,ROMNEY-IN,521,2,11,15,44,120,76
PI591507,2019,ROMNEY-IN,631,2,5,23,44,120,76
PI584441,2019,ROMNEY-IN,94,1,12,9,45,120,75
PI548549,2019,ROMNEY-IN,134,1,5,12,45,120,75
PI548682,2019,ROMNEY-IN,179,1,5,15,46,120,74
PI548410,2019,ROMNEY-IN,537,2,8,16,46,120,74
PI548410,2019,ROMNEY-IN,253,1,9,21,47,120,73
PI437550C,2019,ROMNEY-IN,260,1,2,21,47,120,73
PI547471,2019,ROMNEY-IN,54,1,3,6,48,120,72
PI548275,2019,ROMNEY-IN,137,1,8,12,48,120,72
PI547657,2019,ROMNEY-IN,227,1,9,19,48,120,72
PI547598,2019,ROMNEY-IN,236,1,3,20,48,120,72
PI603564A,2019,ROMNEY-IN,441,2,13,9,49,120,71
PI591532,2019,ROMNEY-IN,132,1,3,12,51,120,69
PI597382,2019,ROMNEY-IN,108,1,5,10,42,119,77
PI591536,2019,ROMNEY-IN,139,1,10,12,42,119,77
PI438500,2019,ROMNEY-IN,188,1,7,16,42,119,77
PI556781,2019,ROMNEY-IN,263,1,4,22,42,119,77
PI591561,2019,ROMNEY-IN,306,1,8,25,42,119,77
PI591506,2019,ROMNEY-IN,352,2,5,2,42,119,77
PI593258,2019,ROMNEY-IN,382,2,9,4,42,119,77
PI574534,2019,ROMNEY-IN,421,2,7,7,42,119,77
PI518663,2019,ROMNEY-IN,422,2,6,7,42,119,77
PI596407,2019,ROMNEY-IN,430,2,5,8,42,119,77
PI437464,2019,ROMNEY-IN,434,2,9,8,42,119,77
PI597387,2019,ROMNEY-IN,604,2,6,21,42,119,77
PI595363,2019,ROMNEY-IN,636,2,3,24,42,119,77
PI591561,2019,ROMNEY-IN,663,2,4,26,42,119,77
PI518673,2019,ROMNEY-IN,86,1,9,8,43,119,76
PI437711B,2019,ROMNEY-IN,127,1,5,11,43,119,76
PI591507,2019,ROMNEY-IN,141,1,12,12,43,119,76
PI556931,2019,ROMNEY-IN,183,1,2,16,43,119,76
PI591539,2019,ROMNEY-IN,198,1,12,17,43,119,76
PI548633,2019,ROMNEY-IN,279,1,9,23,43,119,76
PI547860,2019,ROMNEY-IN,309,1,5,25,43,119,76
PI633729,2019,ROMNEY-IN,345,1,8,28,43,119,76
PI548549,2019,ROMNEY-IN,351,2,4,2,43,119,76
PI591530,2019,ROMNEY-IN,354,2,7,2,43,119,76
PI548517,2019,ROMNEY-IN,372,2,4,3,43,119,76
PI518673,2019,ROMNEY-IN,379,2,6,4,43,119,76
PI633729,2019,ROMNEY-IN,381,2,8,4,43,119,76
PI556778,2019,ROMNEY-IN,384,2,11,4,43,119,76
PI603428D,2019,ROMNEY-IN,392,2,10,5,43,119,76
PI548585,2019,ROMNEY-IN,404,2,5,6,43,119,76
PI603571B,2019,ROMNEY-IN,459,2,8,10,43,119,76
PI591537,2019,ROMNEY-IN,587,2,6,20,43,119,76
PI591497,2019,ROMNEY-IN,623,2,13,23,43,119,76
PI547813,2019,ROMNEY-IN,174,1,10,15,44,119,75
PI548525,2019,ROMNEY-IN,222,1,14,19,44,119,75
PI591512,2019,ROMNEY-IN,224,1,12,19,44,119,75
PI507708,2019,ROMNEY-IN,273,1,14,22,44,119,75
PI591517,2019,ROMNEY-IN,301,1,13,25,44,119,75
PI427136,2019,ROMNEY-IN,380,2,7,4,44,119,75
PI542044,2019,ROMNEY-IN,396,2,6,5,44,119,75
PI547802,2019,ROMNEY-IN,401,2,2,6,44,119,75
PI556816,2019,ROMNEY-IN,426,2,2,7,44,119,75
PI591492,2019,ROMNEY-IN,447,2,7,9,44,119,75
PI548652,2019,ROMNEY-IN,460,2,9,10,44,119,75
PI574541,2019,ROMNEY-IN,495,2,11,13,44,119,75
PI548598,2019,ROMNEY-IN,528,2,4,15,44,119,75
PI591504,2019,ROMNEY-IN,533,2,4,16,44,119,75
PI636464,2019,ROMNEY-IN,550,2,8,17,44,119,75
PI542709,2019,ROMNEY-IN,560,2,5,18,44,119,75
PI547886,2019,ROMNEY-IN,570,2,14,19,44,119,75
PI591513,2019,ROMNEY-IN,571,2,13,19,44,119,75
PI153292,2019,ROMNEY-IN,576,2,8,19,44,119,75
PI603915D,2019,ROMNEY-IN,582,2,2,19,44,119,75
PI547655,2019,ROMNEY-IN,600,2,10,21,44,119,75
PI283331,2019,ROMNEY-IN,640,2,7,24,44,119,75
PI603193,2019,ROMNEY-IN,653,2,9,25,44,119,75
PI547800,2019,ROMNEY-IN,424,2,4,7,45,119,74
PI548177,2019,ROMNEY-IN,435,2,10,8,45,119,74
PI591539,2019,ROMNEY-IN,470,2,10,11,45,119,74
PI547598,2019,ROMNEY-IN,583,2,2,20,45,119,74
PI547545,2019,ROMNEY-IN,289,1,4,24,46,119,73
PI404173B,2019,ROMNEY-IN,418,2,10,7,46,119,73
PI548193,2019,ROMNEY-IN,481,2,4,12,46,119,73
PI533654,2019,ROMNEY-IN,670,2,11,26,46,119,73
PI567366A,2019,ROMNEY-IN,364,2,12,3,47,119,72
PI634762,2019,ROMNEY-IN,370,2,6,3,47,119,72
PI591494,2019,ROMNEY-IN,476,2,4,11,47,119,72
PI437711B,2019,ROMNEY-IN,593,2,12,20,47,119,72
PI548267,2019,ROMNEY-IN,621,2,14,22,47,119,72
PI371611,2019,ROMNEY-IN,657,2,5,25,47,119,72
PI603434,2019,ROMNEY-IN,157,1,2,14,48,119,71
PI603396,2019,ROMNEY-IN,490,2,13,12,48,119,71
PI547471,2019,ROMNEY-IN,501,2,5,13,48,119,71
PI603201,2019,ROMNEY-IN,668,2,9,26,52,119,67
PI534648,2019,ROMNEY-IN,561,2,6,18,41,118,77
PI591537,2019,ROMNEY-IN,109,1,6,10,42,118,76
PI153292,2019,ROMNEY-IN,327,1,13,27,42,118,76
PI633732,2019,ROMNEY-IN,508,2,5,14,42,118,76
PI437903,2019,ROMNEY-IN,36,1,11,4,43,118,75
PI556816,2019,ROMNEY-IN,97,1,9,9,43,118,75
PI548636,2019,ROMNEY-IN,114,1,11,10,43,118,75
PI556778,2019,ROMNEY-IN,194,1,13,16,43,118,75
PI603188,2019,ROMNEY-IN,296,1,11,24,43,118,75
PI534647,2019,ROMNEY-IN,374,2,2,3,43,118,75
PI568245,2019,ROMNEY-IN,477,2,3,11,43,118,75
PI424405A,2019,ROMNEY-IN,523,2,9,15,43,118,75
PI556572,2019,ROMNEY-IN,677,2,11,27,43,118,75
PI591531,2019,ROMNEY-IN,6,1,7,2,44,118,74
PI548585,2019,ROMNEY-IN,10,1,11,2,44,118,74
PI615555,2019,ROMNEY-IN,135,1,6,12,44,118,74
PI547847,2019,ROMNEY-IN,173,1,11,15,44,118,74
PI438079,2019,ROMNEY-IN,547,2,11,17,44,118,74
PI591526,2019,ROMNEY-IN,549,2,9,17,44,118,74
PI547869,2019,ROMNEY-IN,614,2,7,22,44,118,74
PI548192,2019,ROMNEY-IN,107,1,4,10,45,118,73
PI437459,2019,ROMNEY-IN,235,1,2,20,45,118,73
PI603188,2019,ROMNEY-IN,650,2,12,25,46,118,72
PI548339,2019,ROMNEY-IN,184,1,3,16,48,118,70
PI603186,2019,ROMNEY-IN,330,1,10,27,48,118,70
PI591534,2019,ROMNEY-IN,17,1,11,3,42,117,75
PI574534,2019,ROMNEY-IN,45,1,9,5,42,117,75
PI534648,2019,ROMNEY-IN,242,1,9,20,42,117,75
PI437894,2019,ROMNEY-IN,245,1,12,20,42,117,75
PI475822B,2019,ROMNEY-IN,302,1,12,25,42,117,75
PI548558,2019,ROMNEY-IN,14,1,14,3,43,117,74
PI591540,2019,ROMNEY-IN,31,1,6,4,43,117,74
PI591533,2019,ROMNEY-IN,210,1,3,18,43,117,74
PI547798,2019,ROMNEY-IN,76,1,4,7,44,117,73
PI534647,2019,ROMNEY-IN,104,1,2,9,44,117,73
PI567366A,2019,ROMNEY-IN,142,1,13,12,44,117,73
PI591506,2019,ROMNEY-IN,149,1,9,13,44,117,73
PI548174,2019,ROMNEY-IN,193,1,12,16,44,117,73
PI591531,2019,ROMNEY-IN,471,2,9,11,44,117,73
PI547663,2019,ROMNEY-IN,18,1,10,3,45,117,72
PI547500,2019,ROMNEY-IN,21,1,7,3,45,117,72
PI591526,2019,ROMNEY-IN,26,1,2,3,45,117,72
PI547484,2019,ROMNEY-IN,322,1,11,26,45,117,72
PI591528,2019,ROMNEY-IN,468,2,12,11,45,117,72
PI437461,2019,ROMNEY-IN,496,2,10,13,47,117,70
PI437500C,2019,ROMNEY-IN,53,1,2,6,48,117,69
PI603396,2019,ROMNEY-IN,62,1,11,6,49,117,68
PI424405A,2019,ROMNEY-IN,33,1,8,4,42,116,74
PI556511,2019,ROMNEY-IN,48,1,6,5,42,116,74
PI633732,2019,ROMNEY-IN,88,1,11,8,42,116,74
PI591538,2019,ROMNEY-IN,119,1,13,11,42,116,74
PI548231,2019,ROMNEY-IN,189,1,8,16,42,116,74
PI548685,2019,ROMNEY-IN,250,1,12,21,42,116,74
PI548613,2019,ROMNEY-IN,278,1,10,23,42,116,74
PI437467,2019,ROMNEY-IN,299,1,14,24,42,116,74
PI612594,2019,ROMNEY-IN,331,1,9,27,42,116,74
PI548613,2019,ROMNEY-IN,667,2,8,26,42,116,74
PI591510,2019,ROMNEY-IN,68,1,12,7,43,116,73
PI547814,2019,ROMNEY-IN,100,1,6,9,43,116,73
PI614154,2019,ROMNEY-IN,120,1,12,11,43,116,73
PI614832,2019,ROMNEY-IN,138,1,9,12,43,116,73
PI574532,2019,ROMNEY-IN,145,1,13,13,43,116,73
PI548542,2019,ROMNEY-IN,223,1,13,19,43,116,73
PI398881,2019,ROMNEY-IN,328,1,12,27,43,116,73
PI555396,2019,ROMNEY-IN,338,1,2,27,43,116,73
PI437388,2019,ROMNEY-IN,373,2,3,3,43,116,73
PI593654,2019,ROMNEY-IN,405,2,6,6,43,116,73
PI591533,2019,ROMNEY-IN,429,2,4,8,43,116,73
PI547864,2019,ROMNEY-IN,439,2,14,8,43,116,73
PI548340,2019,ROMNEY-IN,446,2,8,9,43,116,73
PI567404A,2019,ROMNEY-IN,485,2,8,12,43,116,73
PI437894,2019,ROMNEY-IN,487,2,10,12,43,116,73
PI603454,2019,ROMNEY-IN,500,2,6,13,43,116,73
PI556511,2019,ROMNEY-IN,546,2,12,17,43,116,73
PI591512,2019,ROMNEY-IN,555,2,3,17,43,116,73
PI548231,2019,ROMNEY-IN,558,2,3,18,43,116,73
PI614154,2019,ROMNEY-IN,562,2,7,18,43,116,73
PI548670,2019,ROMNEY-IN,683,2,5,27,43,116,73
PI593654,2019,ROMNEY-IN,1,1,2,2,44,116,72
PI518663,2019,ROMNEY-IN,27,1,2,4,44,116,72
PI253660A,2019,ROMNEY-IN,102,1,4,9,44,116,72
PI636464,2019,ROMNEY-IN,162,1,7,14,44,116,72
PI547800,2019,ROMNEY-IN,265,1,6,22,44,116,72
PI610670,2019,ROMNEY-IN,275,1,13,23,44,116,72
PI542044,2019,ROMNEY-IN,340,1,3,28,44,116,72
PI595754,2019,ROMNEY-IN,357,2,10,2,44,116,72
PI547484,2019,ROMNEY-IN,367,2,9,3,44,116,72
PI610670,2019,ROMNEY-IN,388,2,14,5,44,116,72
PI548383,2019,ROMNEY-IN,412,2,13,6,44,116,72
PI591519,2019,ROMNEY-IN,448,2,6,9,44,116,72
PI547813,2019,ROMNEY-IN,479,2,2,12,44,116,72
PI475822B,2019,ROMNEY-IN,499,2,7,13,44,116,72
PI547798,2019,ROMNEY-IN,512,2,9,14,44,116,72
PI591538,2019,ROMNEY-IN,578,2,6,19,44,116,72
PI437903,2019,ROMNEY-IN,588,2,7,20,44,116,72
PI437459,2019,ROMNEY-IN,599,2,11,21,44,116,72
PI548242,2019,ROMNEY-IN,641,2,8,24,44,116,72
PI548525,2019,ROMNEY-IN,672,2,13,26,44,116,72
PI547663,2019,ROMNEY-IN,680,2,8,27,44,116,72
PI576160,2019,ROMNEY-IN,684,2,4,27,44,116,72
PI437444,2019,ROMNEY-IN,23,1,5,3,45,116,71
PI438252C,2019,ROMNEY-IN,163,1,8,14,45,116,71
PI548383,2019,ROMNEY-IN,196,1,14,17,45,116,71
PI438124B,2019,ROMNEY-IN,385,2,12,4,45,116,71
PI547500,2019,ROMNEY-IN,410,2,11,6,45,116,71
PI592946,2019,ROMNEY-IN,51,1,3,5,47,116,69
PI548546,2019,ROMNEY-IN,596,2,14,21,47,116,69
PI548614,2019,ROMNEY-IN,231,1,5,19,49,116,67
PI548671,2019,ROMNEY-IN,616,2,9,22,50,116,66
PI548671,2019,ROMNEY-IN,308,1,6,25,51,116,65
PI475822C,2019,ROMNEY-IN,612,2,5,22,51,116,65
PI548518,2019,ROMNEY-IN,69,1,11,7,42,115,73
PI209331,2019,ROMNEY-IN,247,1,14,20,42,115,73
PI561321,2019,ROMNEY-IN,264,1,5,22,42,115,73
PI437500B,2019,ROMNEY-IN,606,2,4,21,42,115,73
PI552538,2019,ROMNEY-IN,620,2,13,22,42,115,73
PI596407,2019,ROMNEY-IN,160,1,5,14,43,115,72
PI547811,2019,ROMNEY-IN,177,1,7,15,43,115,72
PI547501,2019,ROMNEY-IN,311,1,3,25,43,115,72
PI548242,2019,ROMNEY-IN,314,1,3,26,43,115,72
PI437487,2019,ROMNEY-IN,365,2,11,3,43,115,72
PI507708,2019,ROMNEY-IN,423,2,5,7,43,115,72
PI547814,2019,ROMNEY-IN,455,2,4,10,43,115,72
PI534645,2019,ROMNEY-IN,464,2,13,10,43,115,72
PI556687,2019,ROMNEY-IN,466,2,14,11,43,115,72
PI548685,2019,ROMNEY-IN,524,2,8,15,43,115,72
PI564718,2019,ROMNEY-IN,525,2,7,15,43,115,72
PI547885,2019,ROMNEY-IN,597,2,13,21,43,115,72
PI548558,2019,ROMNEY-IN,635,2,2,24,43,115,72
PI437444,2019,ROMNEY-IN,669,2,10,26,43,115,72
PI479740,2019,ROMNEY-IN,5,1,6,2,44,115,71
PI595363,2019,ROMNEY-IN,52,1,2,5,44,115,71
PI564718,2019,ROMNEY-IN,65,1,14,6,44,115,71
PI548421,2019,ROMNEY-IN,71,1,9,7,44,115,71
PI603428D,2019,ROMNEY-IN,262,1,3,22,44,115,71
PI591498,2019,ROMNEY-IN,293,1,8,24,44,115,71
PI438357B,2019,ROMNEY-IN,319,1,8,26,44,115,71
PI548191,2019,ROMNEY-IN,320,1,9,26,44,115,71
PI548632,2019,ROMNEY-IN,360,2,13,2,44,115,71
PI547811,2019,ROMNEY-IN,362,2,14,3,44,115,71
PI437550C,2019,ROMNEY-IN,413,2,14,6,44,115,71
PI548421,2019,ROMNEY-IN,478,2,2,11,44,115,71
PI507692B,2019,ROMNEY-IN,497,2,9,13,44,115,71
PI437391,2019,ROMNEY-IN,530,2,2,15,44,115,71
PI612932,2019,ROMNEY-IN,553,2,5,17,44,115,71
PI518675,2019,ROMNEY-IN,574,2,10,19,44,115,71
PI189926,2019,ROMNEY-IN,615,2,8,22,44,115,71
PI615555,2019,ROMNEY-IN,673,2,14,26,44,115,71
PI595926,2019,ROMNEY-IN,674,2,14,27,44,115,71
PI592946,2019,ROMNEY-IN,391,2,11,5,45,115,70
PI438079,2019,ROMNEY-IN,337,1,3,27,46,115,69
PI603186,2019,ROMNEY-IN,472,2,8,11,46,115,69
PI567404A,2019,ROMNEY-IN,201,1,9,17,47,115,68
PI548339,2019,ROMNEY-IN,402,2,3,6,47,115,68
PI283331,2019,ROMNEY-IN,205,1,5,17,48,115,67
PI595926,2019,ROMNEY-IN,215,1,8,18,42,114,72
PI603442,2019,ROMNEY-IN,276,1,12,23,42,114,72
PI612932,2019,ROMNEY-IN,294,1,9,24,42,114,72
PI612750,2019,ROMNEY-IN,321,1,10,26,42,114,72
PI548597,2019,ROMNEY-IN,349,2,2,2,42,114,72
PI507676,2019,ROMNEY-IN,361,2,14,2,42,114,72
PI556989,2019,ROMNEY-IN,517,2,14,14,42,114,72
PI540555,2019,ROMNEY-IN,543,2,14,16,42,114,72
PI603442,2019,ROMNEY-IN,628,2,8,23,42,114,72
PI547501,2019,ROMNEY-IN,656,2,6,25,42,114,72
PI437467,2019,ROMNEY-IN,638,2,5,24,43,114,71
PI370055,2019,ROMNEY-IN,182,1,2,15,43,114,71
PI548304,2019,ROMNEY-IN,244,1,11,20,43,114,71
PI591505,2019,ROMNEY-IN,248,1,14,21,43,114,71
PI437500B,2019,ROMNEY-IN,334,1,6,27,43,114,71
PI548174,2019,ROMNEY-IN,456,2,5,10,43,114,71
PI438341,2019,ROMNEY-IN,462,2,11,10,43,114,71
PI437377,2019,ROMNEY-IN,492,2,14,13,43,114,71
PI548366,2019,ROMNEY-IN,531,2,2,16,43,114,71
PI437338,2019,ROMNEY-IN,567,2,12,18,43,114,71
PI591534,2019,ROMNEY-IN,573,2,11,19,43,114,71
PI574532,2019,ROMNEY-IN,594,2,13,20,43,114,71
PI438252C,2019,ROMNEY-IN,632,2,4,23,43,114,71
PI548684,2019,ROMNEY-IN,647,2,14,24,43,114,71
PI586980,2019,ROMNEY-IN,681,2,7,27,43,114,71
PI561321,2019,ROMNEY-IN,690,2,5,28,43,114,71
PI548518,2019,ROMNEY-IN,691,2,6,28,43,114,71
PI548365,2019,ROMNEY-IN,74,1,6,7,44,114,70
PI437463B,2019,ROMNEY-IN,214,1,7,18,44,114,70
PI437365,2019,ROMNEY-IN,307,1,7,25,44,114,70
PI437464,2019,ROMNEY-IN,333,1,7,27,44,114,70
PI547802,2019,ROMNEY-IN,335,1,5,27,44,114,70
PI548373,2019,ROMNEY-IN,343,1,6,28,44,114,70
PI591517,2019,ROMNEY-IN,390,2,12,5,44,114,70
PI437365,2019,ROMNEY-IN,407,2,8,6,44,114,70
PI253660A,2019,ROMNEY-IN,432,2,7,8,44,114,70
PI548614,2019,ROMNEY-IN,539,2,10,16,44,114,70
PI548373,2019,ROMNEY-IN,540,2,11,16,44,114,70
PI591540,2019,ROMNEY-IN,559,2,4,18,44,114,70
PI170380,2019,ROMNEY-IN,580,2,4,19,44,114,70
PI556931,2019,ROMNEY-IN,591,2,10,20,44,114,70
PI548381,2019,ROMNEY-IN,629,2,7,23,44,114,70
PI253661B,2019,ROMNEY-IN,651,2,11,25,44,114,70
PI552538,2019,ROMNEY-IN,339,1,2,28,46,114,68
PI437124,2019,ROMNEY-IN,180,1,4,15,47,114,67
PI437422,2019,ROMNEY-IN,332,1,8,27,47,114,67
PI437388,2019,ROMNEY-IN,186,1,5,16,48,114,66
PI437103,2019,ROMNEY-IN,56,1,5,6,49,114,65
PI437338,2019,ROMNEY-IN,268,1,9,22,42,113,71
PI437124,2019,ROMNEY-IN,415,2,13,7,42,113,71
PI189928,2019,ROMNEY-IN,81,1,4,8,43,113,70
PI438486,2019,ROMNEY-IN,116,1,13,10,43,113,70
PI548686,2019,ROMNEY-IN,170,1,14,15,43,113,70
PI417526,2019,ROMNEY-IN,221,1,14,18,43,113,70
PI437317,2019,ROMNEY-IN,443,2,11,9,43,113,70
PI507676,2019,ROMNEY-IN,212,1,5,18,44,113,69
PI437461,2019,ROMNEY-IN,305,1,9,25,44,113,69
PI438486,2019,ROMNEY-IN,431,2,6,8,44,113,69
PI548633,2019,ROMNEY-IN,630,2,6,23,44,113,69
PI634761,2019,ROMNEY-IN,652,2,10,25,44,113,69
PI153243,2019,ROMNEY-IN,658,2,4,25,46,113,67
PI634761,2019,ROMNEY-IN,113,1,10,10,42,112,70
PI561330A,2019,ROMNEY-IN,207,1,3,17,42,112,70
PI438341,2019,ROMNEY-IN,267,1,8,22,42,112,70
PI437317,2019,ROMNEY-IN,271,1,12,22,42,112,70
PI591510,2019,ROMNEY-IN,453,2,2,10,42,112,70
PI548180,2019,ROMNEY-IN,176,1,8,15,43,112,69
PI634764,2019,ROMNEY-IN,211,1,4,18,43,112,69
PI548381,2019,ROMNEY-IN,237,1,4,20,43,112,69
PI548366,2019,ROMNEY-IN,243,1,10,20,43,112,69
PI548597,2019,ROMNEY-IN,255,1,7,21,43,112,69
PI548180,2019,ROMNEY-IN,444,2,10,9,43,112,69
PI548686,2019,ROMNEY-IN,451,2,3,9,43,112,69
PI437392,2019,ROMNEY-IN,463,2,12,10,43,112,69
PI479740,2019,ROMNEY-IN,473,2,7,11,43,112,69
PI189928,2019,ROMNEY-IN,498,2,8,13,43,112,69
PI398881,2019,ROMNEY-IN,526,2,6,15,43,112,69
PI437397,2019,ROMNEY-IN,527,2,5,15,43,112,69
PI437500C,2019,ROMNEY-IN,541,2,12,16,43,112,69
PI548304,2019,ROMNEY-IN,556,2,2,17,43,112,69
PI417526,2019,ROMNEY-IN,579,2,5,19,43,112,69
PI437641B,2019,ROMNEY-IN,595,2,14,20,43,112,69
PI561330A,2019,ROMNEY-IN,608,2,2,21,43,112,69
PI548365,2019,ROMNEY-IN,609,2,2,22,43,112,69
PI548562,2019,ROMNEY-IN,679,2,9,27,43,112,69
PI507692B,2019,ROMNEY-IN,122,1,10,11,44,112,68
PI548517,2019,ROMNEY-IN,143,1,14,12,44,112,68
PI437412,2019,ROMNEY-IN,144,1,14,13,44,112,68
PI548204,2019,ROMNEY-IN,240,1,7,20,44,112,68
PI548684,2019,ROMNEY-IN,269,1,10,22,44,112,68
PI437641B,2019,ROMNEY-IN,317,1,6,26,44,112,68
PI437357,2019,ROMNEY-IN,377,2,4,4,44,112,68
PI548367,2019,ROMNEY-IN,427,2,2,8,44,112,68
PI603434,2019,ROMNEY-IN,436,2,11,8,44,112,68
PI634764,2019,ROMNEY-IN,538,2,9,16,44,112,68
PI437422,2019,ROMNEY-IN,572,2,12,19,44,112,68
PI438310,2019,ROMNEY-IN,585,2,4,20,44,112,68
PI437412,2019,ROMNEY-IN,625,2,11,23,44,112,68
PI437463B,2019,ROMNEY-IN,695,2,10,28,44,112,68
PI253661B,2019,ROMNEY-IN,147,1,11,13,45,112,67
PI170380,2019,ROMNEY-IN,252,1,10,21,46,112,66
PI438310,2019,ROMNEY-IN,185,1,4,16,47,112,65
PI438124B,2019,ROMNEY-IN,93,1,13,9,48,112,64
PI437377,2019,ROMNEY-IN,206,1,4,17,48,112,64
PI437103,2019,ROMNEY-IN,589,2,8,20,49,112,63
PI586980,2019,ROMNEY-IN,39,1,14,4,42,111,69
PI437392,2019,ROMNEY-IN,111,1,8,10,42,111,69
PI437397,2019,ROMNEY-IN,106,1,3,10,43,111,68
PI612750,2019,ROMNEY-IN,454,2,3,10,43,111,68
PI370055,2019,ROMNEY-IN,474,2,6,11,43,110,67
PI548204,2019,ROMNEY-IN,605,2,5,21,44,110,66
PI438409,2019,ROMNEY-IN,581,2,3,19,45,110,65
PI438409,2019,ROMNEY-IN,164,1,9,14,49,110,61
PI437422,2020,ACRE-IN,18,1,13,3,57,122,65
PI475822B,2020,ACRE-IN,55,1,4,5,57,125,68
PI556781,2020,ACRE-IN,19,1,12,3,57,126,69
PI438310,2020,ACRE-IN,195,1,13,14,52,121,69
PI437377,2020,ACRE-IN,523,2,5,10,48,119,71
PI437459,2020,ACRE-IN,227,1,11,17,NA,136,72
PI398881,2020,ACRE-IN,303,1,8,22,47,119,72
PI595926,2020,ACRE-IN,316,1,10,23,47,119,72
PI548686,2020,ACRE-IN,348,1,10,25,47,119,72
PI253661B,2020,ACRE-IN,540,2,7,11,49,121,72
PI398881,2020,ACRE-IN,667,2,4,20,47,119,72
PI437377,2020,ACRE-IN,169,1,12,13,48,121,73
PI556989,2020,ACRE-IN,260,1,7,19,46,119,73
PI548180,2020,ACRE-IN,548,2,2,12,46,119,73
PI253661B,2020,ACRE-IN,8,1,9,2,48,122,74
PI564718,2020,ACRE-IN,58,1,2,5,47,121,74
PI561330A,2020,ACRE-IN,107,1,13,8,50,124,74
PI548597,2020,ACRE-IN,130,1,9,10,45,119,74
PI548180,2020,ACRE-IN,153,1,2,12,47,121,74
PI437103,2020,ACRE-IN,242,1,5,18,47,121,74
PI596407,2020,ACRE-IN,253,1,14,19,47,121,74
PI437641B,2020,ACRE-IN,342,1,14,24,45,119,74
PI507692B,2020,ACRE-IN,377,1,12,27,47,121,74
PI561330A,2020,ACRE-IN,387,1,3,27,45,119,74
PI437463B,2020,ACRE-IN,609,2,5,16,45,119,74
PI586980,2020,ACRE-IN,628,2,4,17,45,119,74
PI437103,2020,ACRE-IN,635,2,3,18,45,119,74
PI283331,2020,ACRE-IN,3,1,4,2,47,122,75
PI253660A,2020,ACRE-IN,53,1,6,5,46,121,75
PI189928,2020,ACRE-IN,54,1,5,5,46,121,75
PI437357,2020,ACRE-IN,344,1,13,25,49,124,75
PI438079,2020,ACRE-IN,397,1,8,28,50,125,75
PI548366,2020,ACRE-IN,512,2,5,9,44,119,75
PI576160,2020,ACRE-IN,528,2,10,10,44,119,75
PI612932,2020,ACRE-IN,542,2,5,11,44,119,75
PI437357,2020,ACRE-IN,551,2,5,12,48,123,75
PI548381,2020,ACRE-IN,686,2,6,21,44,119,75
PI547801,2020,ACRE-IN,693,2,2,21,48,123,75
PI548381,2020,ACRE-IN,59,1,2,6,43,119,76
PI548339,2020,ACRE-IN,113,1,11,9,50,126,76
PI591534,2020,ACRE-IN,258,1,9,19,43,119,76
PI438124B,2020,ACRE-IN,313,1,12,23,47,123,76
PI437412,2020,ACRE-IN,327,1,3,23,43,119,76
PI603434,2020,ACRE-IN,338,1,10,24,43,119,76
PI548525,2020,ACRE-IN,346,1,12,25,50,126,76
PI595926,2020,ACRE-IN,388,1,2,27,43,119,76
PI556511,2020,ACRE-IN,390,1,2,28,43,119,76
PI438409,2020,ACRE-IN,425,2,5,3,43,119,76
PI548685,2020,ACRE-IN,442,2,12,4,43,119,76
PI548304,2020,ACRE-IN,525,2,7,10,43,119,76
PI548597,2020,ACRE-IN,657,2,6,19,43,119,76
PI612932,2020,ACRE-IN,24,1,7,3,47,124,77
PI547801,2020,ACRE-IN,246,1,8,18,48,125,77
PI556511,2020,ACRE-IN,269,1,5,20,42,119,77
PI548231,2020,ACRE-IN,466,2,7,6,42,119,77
PI603186,2020,ACRE-IN,514,2,4,9,47,124,77
PI574532,2020,ACRE-IN,517,2,1,9,42,119,77
PI595363,2020,ACRE-IN,520,2,3,10,42,119,77
PI548613,2020,ACRE-IN,529,2,11,10,42,119,77
PI547501,2020,ACRE-IN,534,2,12,11,42,119,77
PI438124B,2020,ACRE-IN,539,2,8,11,44,121,77
PI438310,2020,ACRE-IN,564,2,11,13,48,125,77
PI437412,2020,ACRE-IN,588,2,13,14,42,119,77
PI507708,2020,ACRE-IN,617,2,13,16,42,119,77
PI548562,2020,ACRE-IN,632,2,1,17,42,119,77
PI548542,2020,ACRE-IN,5,1,6,2,45,123,78
PI437463B,2020,ACRE-IN,32,1,4,4,39,117,78
PI437124,2020,ACRE-IN,75,1,14,6,43,121,78
PI507708,2020,ACRE-IN,118,1,6,9,42,120,78
PI603396,2020,ACRE-IN,173,1,8,13,51,129,78
PI438409,2020,ACRE-IN,197,1,14,15,41,119,78
PI610670,2020,ACRE-IN,235,1,4,17,47,125,78
PI548231,2020,ACRE-IN,259,1,8,19,43,121,78
PI438486,2020,ACRE-IN,273,1,9,20,48,126,78
PI548558,2020,ACRE-IN,306,1,11,22,46,124,78
PI437903,2020,ACRE-IN,391,1,3,28,49,127,78
PI634762,2020,ACRE-IN,398,1,9,28,49,127,78
PI548247,2020,ACRE-IN,406,2,6,2,50,128,78
PI568245,2020,ACRE-IN,511,2,6,9,49,127,78
PI591515,2020,ACRE-IN,526,2,8,10,45,123,78
PI437500C,2020,ACRE-IN,681,2,10,21,41,119,78
PI209331,2020,ACRE-IN,689,2,4,21,41,119,78
PI548635,2020,ACRE-IN,29,1,2,3,49,128,79
PI574532,2020,ACRE-IN,102,1,8,8,41,120,79
PI548532,2020,ACRE-IN,157,1,5,12,49,128,79
PI547663,2020,ACRE-IN,159,1,7,12,47,126,79
PI593654,2020,ACRE-IN,181,1,3,14,42,121,79
PI518673,2020,ACRE-IN,182,1,4,14,50,129,79
PI547501,2020,ACRE-IN,184,1,5,14,40,119,79
PI534647,2020,ACRE-IN,206,1,5,15,47,126,79
PI547813,2020,ACRE-IN,262,1,5,19,47,126,79
PI576160,2020,ACRE-IN,263,1,4,19,45,124,79
PI547798,2020,ACRE-IN,360,1,3,26,47,126,79
PI507676,2020,ACRE-IN,436,2,6,4,45,124,79
PI548547,2020,ACRE-IN,467,2,8,6,49,128,79
PI548525,2020,ACRE-IN,504,2,13,9,49,128,79
PI606748,2020,ACRE-IN,9,1,10,2,57,137,80
PI591512,2020,ACRE-IN,20,1,11,3,46,126,80
PI591530,2020,ACRE-IN,28,1,3,3,48,128,80
PI586980,2020,ACRE-IN,90,1,4,7,42,122,80
PI507676,2020,ACRE-IN,91,1,3,7,39,119,80
PI548562,2020,ACRE-IN,139,1,13,11,43,123,80
PI548685,2020,ACRE-IN,172,1,9,13,40,120,80
PI568245,2020,ACRE-IN,180,1,2,14,49,129,80
PI614832,2020,ACRE-IN,185,1,6,14,41,121,80
PI556687,2020,ACRE-IN,189,1,7,14,43,123,80
PI209331,2020,ACRE-IN,265,1,2,19,39,119,80
PI437500C,2020,ACRE-IN,270,1,6,20,39,119,80
PI548613,2020,ACRE-IN,271,1,7,20,39,119,80
PI593463,2020,ACRE-IN,288,1,7,21,43,123,80
PI592946,2020,ACRE-IN,317,1,9,23,49,129,80
PI437903,2020,ACRE-IN,323,1,4,23,48,128,80
PI603454,2020,ACRE-IN,359,1,2,26,48,128,80
PI547800,2020,ACRE-IN,460,2,1,6,44,124,80
PI561321,2020,ACRE-IN,469,2,10,6,39,119,80
PI593654,2020,ACRE-IN,470,2,11,6,39,119,80
PI438486,2020,ACRE-IN,478,2,8,7,48,128,80
PI596407,2020,ACRE-IN,568,2,7,13,45,125,80
PI437365,2020,ACRE-IN,581,2,7,14,49,129,80
PI548204,2020,ACRE-IN,616,2,12,16,48,128,80
PI603396,2020,ACRE-IN,620,2,11,17,49,129,80
PI170380,2020,ACRE-IN,660,2,3,19,49,129,80
PI603201,2020,ACRE-IN,1,1,2,2,54,135,81
PI548373,2020,ACRE-IN,48,1,11,5,48,129,81
PI548177,2020,ACRE-IN,98,1,5,8,48,129,81
PI432359,2020,ACRE-IN,105,1,11,8,49,130,81
PI548632,2020,ACRE-IN,138,1,14,11,47,128,81
PI548204,2020,ACRE-IN,174,1,7,13,51,132,81
PI574534,2020,ACRE-IN,207,1,4,15,44,125,81
PI547811,2020,ACRE-IN,211,1,3,16,42,123,81
PI427136,2020,ACRE-IN,222,1,13,16,48,129,81
PI153243,2020,ACRE-IN,261,1,6,19,47,128,81
PI547798,2020,ACRE-IN,275,1,10,20,44,125,81
PI542709,2020,ACRE-IN,279,1,13,20,45,126,81
PI591539,2020,ACRE-IN,283,1,12,21,47,128,81
PI591493,2020,ACRE-IN,322,1,5,23,52,133,81
PI591538,2020,ACRE-IN,347,1,11,25,47,128,81
PI437422,2020,ACRE-IN,362,1,4,26,43,124,81
PI548632,2020,ACRE-IN,370,1,11,26,45,126,81
PI591497,2020,ACRE-IN,412,2,11,2,46,127,81
PI437550C,2020,ACRE-IN,446,2,12,5,43,124,81
PI614154,2020,ACRE-IN,471,2,12,6,38,119,81
PI548558,2020,ACRE-IN,485,2,3,7,47,128,81
PI556989,2020,ACRE-IN,487,2,1,7,46,127,81
PI578057,2020,ACRE-IN,532,2,13,11,46,127,81
PI548177,2020,ACRE-IN,567,2,8,13,48,129,81
PI427136,2020,ACRE-IN,577,2,3,14,49,130,81
PI437124,2020,ACRE-IN,613,2,9,16,43,124,81
PI548635,2020,ACRE-IN,654,2,9,19,47,128,81
PI603434,2020,ACRE-IN,655,2,8,19,43,124,81
PI615555,2020,ACRE-IN,683,2,8,21,43,124,81
PI475822B,2020,ACRE-IN,690,2,3,21,38,119,81
PI547500,2020,ACRE-IN,22,1,9,3,47,129,82
PI603442,2020,ACRE-IN,47,1,12,5,39,121,82
PI556928,2020,ACRE-IN,51,1,8,5,46,128,82
PI547869,2020,ACRE-IN,56,1,3,5,47,129,82
PI634764,2020,ACRE-IN,76,1,14,7,47,129,82
PI170380,2020,ACRE-IN,77,1,13,7,46,128,82
PI591498,2020,ACRE-IN,82,1,11,7,46,128,82
PI542711,2020,ACRE-IN,108,1,14,8,47,129,82
PI518675,2020,ACRE-IN,109,1,14,9,39,121,82
PI547802,2020,ACRE-IN,156,1,4,12,47,129,82
PI634761,2020,ACRE-IN,160,1,8,12,47,129,82
PI548194,2020,ACRE-IN,194,1,12,14,51,133,82
PI438079,2020,ACRE-IN,203,1,8,15,47,129,82
PI479740,2020,ACRE-IN,210,1,2,16,42,124,82
PI591531,2020,ACRE-IN,216,1,8,16,47,129,82
PI547886,2020,ACRE-IN,239,1,2,18,47,129,82
PI548671,2020,ACRE-IN,250,1,12,18,55,137,82
PI525454,2020,ACRE-IN,264,1,3,19,47,129,82
PI437359,2020,ACRE-IN,268,1,4,20,43,125,82
PI595754,2020,ACRE-IN,319,1,7,23,47,129,82
PI547813,2020,ACRE-IN,383,1,7,27,45,127,82
PI610670,2020,ACRE-IN,384,1,6,27,43,125,82
PI548542,2020,ACRE-IN,386,1,4,27,49,131,82
PI547885,2020,ACRE-IN,403,2,3,2,46,128,82
PI547811,2020,ACRE-IN,419,2,10,3,43,125,82
PI438341,2020,ACRE-IN,452,2,6,5,37,119,82
PI548614,2020,ACRE-IN,454,2,4,5,43,125,82
PI437317,2020,ACRE-IN,475,2,11,7,44,126,82
PI612750,2020,ACRE-IN,497,2,9,8,42,124,82
PI593256,2020,ACRE-IN,516,2,2,9,46,128,82
PI615556,2020,ACRE-IN,519,2,2,10,43,125,82
PI437711B,2020,ACRE-IN,524,2,6,10,46,128,82
PI548253,2020,ACRE-IN,552,2,6,12,46,128,82
PI153243,2020,ACRE-IN,554,2,7,12,45,127,82
PI548686,2020,ACRE-IN,604,2,1,15,44,126,82
PI552538,2020,ACRE-IN,625,2,7,17,42,124,82
PI591510,2020,ACRE-IN,634,2,2,18,47,129,82
PI548174,2020,ACRE-IN,643,2,10,18,48,130,82
PI603442,2020,ACRE-IN,661,2,2,19,41,123,82
PI547860,2020,ACRE-IN,665,2,2,20,46,128,82
PI591539,2020,ACRE-IN,666,2,3,20,47,129,82
PI634765,2020,ACRE-IN,674,2,11,20,44,126,82
PI547484,2020,ACRE-IN,12,1,11,2,45,128,83
PI597382,2020,ACRE-IN,13,1,12,2,45,128,83
PI603428D,2020,ACRE-IN,17,1,14,3,47,130,83
PI437550C,2020,ACRE-IN,21,1,10,3,41,124,83
PI189935,2020,ACRE-IN,27,1,4,3,49,132,83
PI438252C,2020,ACRE-IN,31,1,3,4,46,129,83
PI547657,2020,ACRE-IN,37,1,9,4,49,132,83
PI548275,2020,ACRE-IN,42,1,13,4,46,129,83
PI578057,2020,ACRE-IN,44,1,14,5,46,129,83
PI548547,2020,ACRE-IN,46,1,13,5,47,130,83
PI556778,2020,ACRE-IN,83,1,10,7,47,130,83
PI547471,2020,ACRE-IN,95,1,2,8,53,136,83
PI547800,2020,ACRE-IN,99,1,6,8,43,126,83
PI437444,2020,ACRE-IN,100,1,7,8,45,128,83
PI547655,2020,ACRE-IN,103,1,9,8,47,130,83
PI437500B,2020,ACRE-IN,104,1,10,8,46,129,83
PI548304,2020,ACRE-IN,117,1,7,9,42,125,83
PI603188,2020,ACRE-IN,192,1,10,14,46,129,83
PI437894,2020,ACRE-IN,205,1,6,15,46,129,83
PI437397,2020,ACRE-IN,237,1,3,17,43,126,83
PI548684,2020,ACRE-IN,240,1,3,18,43,126,83
PI584441,2020,ACRE-IN,257,1,10,19,47,130,83
PI547847,2020,ACRE-IN,266,1,2,20,47,130,83
PI417526,2020,ACRE-IN,277,1,12,20,45,128,83
PI548365,2020,ACRE-IN,301,1,6,22,43,126,83
PI370055,2020,ACRE-IN,311,1,14,23,45,128,83
PI547598,2020,ACRE-IN,354,1,5,25,49,132,83
PI634761,2020,ACRE-IN,369,1,10,26,45,128,83
PI548373,2020,ACRE-IN,404,2,4,2,45,128,83
PI592946,2020,ACRE-IN,405,2,5,2,46,129,83
PI437338,2020,ACRE-IN,413,2,12,2,45,128,83
PI556687,2020,ACRE-IN,415,2,13,2,42,125,83
PI591518,2020,ACRE-IN,420,2,9,3,49,132,83
PI603188,2020,ACRE-IN,450,2,8,5,45,128,83
PI548518,2020,ACRE-IN,455,2,3,5,43,126,83
PI547814,2020,ACRE-IN,476,2,10,7,44,127,83
PI591516,2020,ACRE-IN,515,2,3,9,46,129,83
PI534646,2020,ACRE-IN,518,2,1,10,43,126,83
PI591503,2020,ACRE-IN,545,2,2,11,45,128,83
PI547500,2020,ACRE-IN,599,2,5,15,45,128,83
PI595754,2020,ACRE-IN,606,2,2,16,46,129,83
PI567366A,2020,ACRE-IN,648,2,13,19,45,128,83
PI547655,2020,ACRE-IN,668,2,5,20,45,128,83
PI634763,2020,ACRE-IN,7,1,8,2,49,133,84
PI404173B,2020,ACRE-IN,16,1,14,2,51,135,84
PI612750,2020,ACRE-IN,26,1,5,3,39,123,84
PI548247,2020,ACRE-IN,87,1,7,7,46,130,84
PI518663,2020,ACRE-IN,146,1,7,11,41,125,84
PI437365,2020,ACRE-IN,150,1,3,11,44,128,84
PI591535,2020,ACRE-IN,167,1,14,13,47,131,84
PI614154,2020,ACRE-IN,208,1,3,15,40,124,84
PI547814,2020,ACRE-IN,213,1,5,16,41,125,84
PI507692B,2020,ACRE-IN,217,1,9,16,46,130,84
PI561321,2020,ACRE-IN,272,1,8,20,39,123,84
PI548421,2020,ACRE-IN,298,1,4,22,49,133,84
PI548678,2020,ACRE-IN,343,1,14,25,54,138,84
PI525454,2020,ACRE-IN,350,1,8,25,44,128,84
PI437487,2020,ACRE-IN,357,1,3,25,43,127,84
PI591499,2020,ACRE-IN,385,1,5,27,49,133,84
PI437641B,2020,ACRE-IN,437,2,7,4,43,127,84
PI518663,2020,ACRE-IN,482,2,5,7,42,126,84
PI555399,2020,ACRE-IN,506,2,11,9,50,134,84
PI370055,2020,ACRE-IN,510,2,7,9,44,128,84
PI633729,2020,ACRE-IN,522,2,4,10,44,128,84
PI437461,2020,ACRE-IN,557,2,10,12,44,128,84
PI603428D,2020,ACRE-IN,605,2,1,16,45,129,84
PI437397,2020,ACRE-IN,629,2,3,17,45,129,84
PI533654,2020,ACRE-IN,659,2,4,19,48,132,84
PI534645,2020,ACRE-IN,677,2,13,21,39,123,84
PI591513,2020,ACRE-IN,694,2,1,21,46,130,84
PI555399,2020,ACRE-IN,2,1,3,2,53,138,85
PI437467,2020,ACRE-IN,6,1,7,2,45,130,85
PI548549,2020,ACRE-IN,14,1,13,2,46,131,85
PI437317,2020,ACRE-IN,68,1,9,6,38,123,85
PI437338,2020,ACRE-IN,106,1,12,8,45,130,85
PI548546,2020,ACRE-IN,110,1,13,9,50,135,85
PI548603,2020,ACRE-IN,120,1,4,9,51,136,85
PI548518,2020,ACRE-IN,136,1,14,10,41,126,85
PI548367,2020,ACRE-IN,215,1,7,16,44,129,85
PI540555,2020,ACRE-IN,284,1,11,21,43,128,85
PI591503,2020,ACRE-IN,285,1,10,21,43,128,85
PI547545,2020,ACRE-IN,287,1,8,21,48,133,85
PI591505,2020,ACRE-IN,293,1,2,21,47,132,85
PI437388,2020,ACRE-IN,308,1,13,22,49,134,85
PI547860,2020,ACRE-IN,314,1,11,23,46,131,85
PI603193,2020,ACRE-IN,329,1,2,24,45,130,85
PI547885,2020,ACRE-IN,335,1,8,24,46,131,85
PI597382,2020,ACRE-IN,358,1,2,25,43,128,85
PI556816,2020,ACRE-IN,363,1,5,26,42,127,85
PI547847,2020,ACRE-IN,364,1,6,26,47,132,85
PI438500,2020,ACRE-IN,365,1,7,26,43,128,85
PI548412,2020,ACRE-IN,368,1,9,26,43,128,85
PI547484,2020,ACRE-IN,376,1,13,27,43,128,85
PI591519,2020,ACRE-IN,378,1,11,27,43,128,85
PI548297,2020,ACRE-IN,382,1,8,27,48,133,85
PI564718,2020,ACRE-IN,411,2,10,2,43,128,85
PI556859,2020,ACRE-IN,423,2,7,3,43,128,85
PI591538,2020,ACRE-IN,426,2,4,3,43,128,85
PI591517,2020,ACRE-IN,439,2,9,4,43,128,85
PI591534,2020,ACRE-IN,451,2,7,5,43,128,85
PI591540,2020,ACRE-IN,461,2,2,6,44,129,85
PI612594,2020,ACRE-IN,464,2,5,6,43,128,85
PI548365,2020,ACRE-IN,472,2,13,6,43,128,85
PI547869,2020,ACRE-IN,477,2,9,7,46,131,85
PI603193,2020,ACRE-IN,479,2,7,7,43,128,85
PI437359,2020,ACRE-IN,509,2,8,9,43,128,85
PI591533,2020,ACRE-IN,531,2,13,10,43,128,85
PI479740,2020,ACRE-IN,535,2,11,11,43,128,85
PI593463,2020,ACRE-IN,537,2,10,11,43,128,85
PI591561,2020,ACRE-IN,538,2,9,11,42,127,85
PI534647,2020,ACRE-IN,543,2,4,11,39,124,85
PI556781,2020,ACRE-IN,546,2,1,11,43,128,85
PI189928,2020,ACRE-IN,556,2,9,12,44,129,85
PI548193,2020,ACRE-IN,573,2,2,13,48,133,85
PI417573,2020,ACRE-IN,595,2,9,15,44,129,85
PI548652,2020,ACRE-IN,610,2,6,16,43,128,85
PI437467,2020,ACRE-IN,618,2,13,17,44,129,85
PI542044,2020,ACRE-IN,619,2,12,17,43,128,85
PI591531,2020,ACRE-IN,644,2,11,18,43,128,85
PI574534,2020,ACRE-IN,664,2,1,20,43,128,85
PI591504,2020,ACRE-IN,676,2,13,20,47,132,85
PI283331,2020,ACRE-IN,688,2,5,21,43,128,85
PI634762,2020,ACRE-IN,23,1,8,3,48,134,86
PI548412,2020,ACRE-IN,63,1,4,6,40,126,86
PI547598,2020,ACRE-IN,65,1,6,6,49,135,86
PI548585,2020,ACRE-IN,124,1,3,10,43,129,86
PI548614,2020,ACRE-IN,128,1,7,10,42,128,86
PI533654,2020,ACRE-IN,154,1,3,12,49,135,86
PI603915D,2020,ACRE-IN,158,1,6,12,47,133,86
PI591516,2020,ACRE-IN,170,1,11,13,47,133,86
PI437461,2020,ACRE-IN,178,1,3,13,42,128,86
PI615556,2020,ACRE-IN,193,1,11,14,47,133,86
PI548174,2020,ACRE-IN,200,1,11,15,49,135,86
PI548192,2020,ACRE-IN,204,1,7,15,47,133,86
PI591510,2020,ACRE-IN,219,1,11,16,47,133,86
PI603186,2020,ACRE-IN,225,1,13,17,47,133,86
PI437392,2020,ACRE-IN,226,1,12,17,43,129,86
PI556816,2020,ACRE-IN,241,1,4,18,43,129,86
PI603205,2020,ACRE-IN,245,1,7,18,50,136,86
PI424405A,2020,ACRE-IN,252,1,14,18,43,129,86
PI615555,2020,ACRE-IN,256,1,11,19,43,129,86
PI603564A,2020,ACRE-IN,281,1,14,21,42,128,86
PI437391,2020,ACRE-IN,282,1,13,21,43,129,86
PI602449,2020,ACRE-IN,296,1,3,22,47,133,86
PI534645,2020,ACRE-IN,312,1,13,23,37,123,86
PI556931,2020,ACRE-IN,328,1,2,23,43,129,86
PI556780,2020,ACRE-IN,353,1,6,25,47,133,86
PI548267,2020,ACRE-IN,381,1,9,27,49,135,86
PI548421,2020,ACRE-IN,396,1,7,28,47,133,86
PI574541,2020,ACRE-IN,400,1,11,28,47,133,86
PI636464,2020,ACRE-IN,430,2,1,4,43,129,86
PI542709,2020,ACRE-IN,434,2,4,4,43,129,86
PI518675,2020,ACRE-IN,448,2,10,5,38,124,86
PI547663,2020,ACRE-IN,449,2,9,5,45,131,86
PI547886,2020,ACRE-IN,465,2,6,6,43,129,86
PI603205,2020,ACRE-IN,508,2,9,9,49,135,86
PI540555,2020,ACRE-IN,527,2,9,10,42,128,86
PI591505,2020,ACRE-IN,549,2,3,12,50,136,86
PI591506,2020,ACRE-IN,558,2,11,12,45,131,86
PI424405A,2020,ACRE-IN,563,2,12,13,42,128,86
PI548400,2020,ACRE-IN,584,2,10,14,49,135,86
PI548532,2020,ACRE-IN,585,2,11,14,49,135,86
PI548636,2020,ACRE-IN,591,2,13,15,49,135,86
PI614832,2020,ACRE-IN,611,2,7,16,42,128,86
PI556572,2020,ACRE-IN,615,2,11,16,43,129,86
PI437894,2020,ACRE-IN,627,2,5,17,43,129,86
PI548633,2020,ACRE-IN,647,2,13,18,43,129,86
PI548242,2020,ACRE-IN,651,2,11,19,43,129,86
PI603571B,2020,ACRE-IN,658,2,5,19,47,133,86
PI634764,2020,ACRE-IN,680,2,11,21,47,133,86
PI548555,2020,ACRE-IN,4,1,5,2,45,132,87
PI636464,2020,ACRE-IN,49,1,10,5,41,128,87
PI591509,2020,ACRE-IN,86,1,8,7,43,130,87
PI548670,2020,ACRE-IN,97,1,4,8,41,128,87
PI591532,2020,ACRE-IN,111,1,12,9,45,132,87
PI548652,2020,ACRE-IN,116,1,8,9,43,130,87
PI438500,2020,ACRE-IN,119,1,5,9,41,128,87
PI591497,2020,ACRE-IN,127,1,6,10,46,133,87
PI593258,2020,ACRE-IN,134,1,13,10,39,126,87
PI548633,2020,ACRE-IN,147,1,6,11,45,132,87
PI547617,2020,ACRE-IN,164,1,12,12,48,135,87
PI548297,2020,ACRE-IN,165,1,13,12,48,135,87
PI548193,2020,ACRE-IN,171,1,10,13,47,134,87
PI424405B,2020,ACRE-IN,209,1,2,15,48,135,87
PI591519,2020,ACRE-IN,223,1,14,16,46,133,87
PI542044,2020,ACRE-IN,228,1,10,17,46,133,87
PI548400,2020,ACRE-IN,230,1,8,17,47,134,87
PI437711B,2020,ACRE-IN,232,1,6,17,48,135,87
PI548222,2020,ACRE-IN,238,1,2,17,41,128,87
PI603564C,2020,ACRE-IN,289,1,6,21,49,136,87
PI548267,2020,ACRE-IN,291,1,4,21,48,135,87
PI560207,2020,ACRE-IN,331,1,4,24,50,137,87
PI437464,2020,ACRE-IN,349,1,9,25,45,132,87
PI548262,2020,ACRE-IN,351,1,7,25,44,131,87
PI548367,2020,ACRE-IN,355,1,4,25,44,131,87
PI437444,2020,ACRE-IN,371,1,12,26,47,134,87
PI547802,2020,ACRE-IN,428,2,2,3,46,133,87
PI518673,2020,ACRE-IN,429,2,1,3,45,132,87
PI591512,2020,ACRE-IN,432,2,2,4,45,132,87
PI547617,2020,ACRE-IN,440,2,10,4,46,133,87
PI556778,2020,ACRE-IN,492,2,5,8,46,133,87
PI253660A,2020,ACRE-IN,493,2,6,8,44,131,87
PI548671,2020,ACRE-IN,571,2,4,13,51,138,87
PI548194,2020,ACRE-IN,572,2,3,13,49,136,87
PI591526,2020,ACRE-IN,594,2,10,15,44,131,87
PI603564A,2020,ACRE-IN,596,2,8,15,42,129,87
PI404173B,2020,ACRE-IN,601,2,4,15,49,136,87
PI634763,2020,ACRE-IN,633,2,1,18,48,135,87
PI547879,2020,ACRE-IN,637,2,5,18,49,136,87
PI636695,2020,ACRE-IN,638,2,6,18,48,135,87
PI556931,2020,ACRE-IN,639,2,7,18,42,129,87
PI548585,2020,ACRE-IN,682,2,9,21,43,130,87
PI437392,2020,ACRE-IN,685,2,7,21,41,128,87
PI567351B,2020,ACRE-IN,25,1,6,3,49,137,88
PI437367,2020,ACRE-IN,43,1,14,4,47,135,88
PI534646,2020,ACRE-IN,64,1,5,6,45,133,88
PI424159B,2020,ACRE-IN,132,1,11,10,46,134,88
PI547879,2020,ACRE-IN,140,1,12,11,49,137,88
PI591492,2020,ACRE-IN,142,1,10,11,49,137,88
PI591499,2020,ACRE-IN,148,1,5,11,47,135,88
PI556814,2020,ACRE-IN,166,1,14,12,44,132,88
PI591506,2020,ACRE-IN,191,1,9,14,45,133,88
PI548517,2020,ACRE-IN,201,1,10,15,47,135,88
PI556572,2020,ACRE-IN,212,1,4,16,42,130,88
PI547477,2020,ACRE-IN,248,1,10,18,49,137,88
PI602450,2020,ACRE-IN,251,1,13,18,49,137,88
PI556780,2020,ACRE-IN,255,1,12,19,47,135,88
PI515961,2020,ACRE-IN,286,1,9,21,50,138,88
PI548262,2020,ACRE-IN,290,1,5,21,41,129,88
PI591540,2020,ACRE-IN,292,1,3,21,43,131,88
PI591521,2020,ACRE-IN,295,1,2,22,45,133,88
PI547876,2020,ACRE-IN,302,1,7,22,47,135,88
PI371611,2020,ACRE-IN,318,1,8,23,48,136,88
PI548191,2020,ACRE-IN,330,1,3,24,51,139,88
PI567767B,2020,ACRE-IN,339,1,11,24,45,133,88
PI371611,2020,ACRE-IN,374,1,14,26,47,135,88
PI189926,2020,ACRE-IN,401,2,1,2,45,133,88
PI603201,2020,ACRE-IN,407,2,7,2,50,138,88
PI437500B,2020,ACRE-IN,427,2,3,3,43,131,88
PI437391,2020,ACRE-IN,447,2,11,5,43,131,88
PI591509,2020,ACRE-IN,462,2,3,6,43,131,88
PI593258,2020,ACRE-IN,463,2,4,6,43,131,88
PI603915D,2020,ACRE-IN,484,2,4,7,47,135,88
PI591535,2020,ACRE-IN,495,2,8,8,45,133,88
PI591494,2020,ACRE-IN,507,2,10,9,49,137,88
PI548191,2020,ACRE-IN,530,2,12,10,48,136,88
PI548222,2020,ACRE-IN,593,2,11,15,43,131,88
PI548678,2020,ACRE-IN,597,2,7,15,49,137,88
PI542711,2020,ACRE-IN,598,2,6,15,42,130,88
PI584441,2020,ACRE-IN,624,2,8,17,45,133,88
PI432359,2020,ACRE-IN,636,2,4,18,47,135,88
PI438357B,2020,ACRE-IN,641,2,8,18,47,135,88
PI548684,2020,ACRE-IN,669,2,6,20,41,129,88
PI577798,2020,ACRE-IN,30,1,2,4,47,136,89
PI591504,2020,ACRE-IN,41,1,12,4,44,133,89
PI591513,2020,ACRE-IN,66,1,7,6,46,135,89
PI538401B,2020,ACRE-IN,70,1,11,6,47,136,89
PI591517,2020,ACRE-IN,73,1,13,6,45,134,89
PI591518,2020,ACRE-IN,80,1,12,7,43,132,89
PI548636,2020,ACRE-IN,84,1,9,7,46,135,89
PI574541,2020,ACRE-IN,88,1,6,7,45,134,89
PI547497,2020,ACRE-IN,96,1,3,8,46,135,89
PI548383,2020,ACRE-IN,114,1,10,9,47,136,89
PI591526,2020,ACRE-IN,125,1,4,10,44,133,89
PI603571B,2020,ACRE-IN,126,1,5,10,46,135,89
PI548410,2020,ACRE-IN,129,1,8,10,49,138,89
PI548598,2020,ACRE-IN,133,1,12,10,49,138,89
PI591533,2020,ACRE-IN,143,1,9,11,41,130,89
PI593256,2020,ACRE-IN,144,1,8,11,47,136,89
PI612594,2020,ACRE-IN,149,1,4,11,41,130,89
PI634765,2020,ACRE-IN,151,1,2,11,43,132,89
PI591494,2020,ACRE-IN,163,1,11,12,49,138,89
PI417573,2020,ACRE-IN,168,1,13,13,43,132,89
PI614153,2020,ACRE-IN,179,1,2,13,38,127,89
PI567527,2020,ACRE-IN,196,1,14,14,48,137,89
PI437464,2020,ACRE-IN,202,1,9,15,47,136,89
PI591528,2020,ACRE-IN,218,1,10,16,47,136,89
PI591561,2020,ACRE-IN,233,1,5,17,43,132,89
PI567404A,2020,ACRE-IN,244,1,6,18,46,135,89
PI591537,2020,ACRE-IN,247,1,9,18,46,135,89
PI567366A,2020,ACRE-IN,249,1,11,18,47,136,89
PI591495,2020,ACRE-IN,254,1,13,19,48,137,89
PI591507,2020,ACRE-IN,299,1,5,22,45,134,89
PI438357B,2020,ACRE-IN,332,1,5,24,47,136,89
PI475822C,2020,ACRE-IN,336,1,9,24,48,137,89
PI548541,2020,ACRE-IN,340,1,12,24,50,139,89
PI603564B,2020,ACRE-IN,341,1,13,24,48,137,89
PI548555,2020,ACRE-IN,380,1,10,27,46,135,89
PI591532,2020,ACRE-IN,399,1,10,28,47,136,89
PI560207,2020,ACRE-IN,408,2,8,2,50,139,89
PI556932,2020,ACRE-IN,410,2,9,2,49,138,89
PI547471,2020,ACRE-IN,417,2,12,3,48,137,89
PI417526,2020,ACRE-IN,453,2,5,5,44,133,89
PI591507,2020,ACRE-IN,457,2,1,5,46,135,89
PI555396,2020,ACRE-IN,489,2,2,8,47,136,89
PI548517,2020,ACRE-IN,500,2,12,8,45,134,89
PI556814,2020,ACRE-IN,505,2,12,9,43,132,89
PI547545,2020,ACRE-IN,547,2,1,12,47,136,89
PI591528,2020,ACRE-IN,562,2,13,13,47,136,89
PI642055,2020,ACRE-IN,566,2,9,13,50,139,89
PI547657,2020,ACRE-IN,569,2,6,13,46,135,89
PI547864,2020,ACRE-IN,574,2,1,13,47,136,89
PI548333,2020,ACRE-IN,576,2,2,14,44,133,89
PI248402,2020,ACRE-IN,607,2,3,16,49,138,89
PI437367,2020,ACRE-IN,614,2,10,16,47,136,89
PI424405B,2020,ACRE-IN,621,2,10,17,47,136,89
PI567767B,2020,ACRE-IN,630,2,2,17,46,135,89
PI548286,2020,ACRE-IN,656,2,7,19,43,132,89
PI548275,2020,ACRE-IN,663,2,1,19,47,136,89
PI556928,2020,ACRE-IN,671,2,8,20,39,128,89
PI548366,2020,ACRE-IN,33,1,5,4,NA,117,90
PI556889,2020,ACRE-IN,69,1,10,6,47,137,90
PI548333,2020,ACRE-IN,71,1,12,6,39,129,90
PI507696C,2020,ACRE-IN,115,1,9,9,43,133,90
PI591536,2020,ACRE-IN,162,1,10,12,48,138,90
PI556932,2020,ACRE-IN,198,1,13,15,47,137,90
PI548250,2020,ACRE-IN,220,1,12,16,48,138,90
PI633729,2020,ACRE-IN,229,1,9,17,45,135,90
PI548682,2020,ACRE-IN,267,1,3,20,46,136,90
PI548602,2020,ACRE-IN,280,1,14,20,48,138,90
PI548253,2020,ACRE-IN,304,1,9,22,43,133,90
PI606749,2020,ACRE-IN,307,1,12,22,46,136,90
PI591536,2020,ACRE-IN,373,1,13,26,47,137,90
PI548598,2020,ACRE-IN,395,1,6,28,49,139,90
PI614153,2020,ACRE-IN,402,2,2,2,42,132,90
PI591495,2020,ACRE-IN,414,2,13,2,49,139,90
PI567404A,2020,ACRE-IN,418,2,11,3,46,136,90
PI548546,2020,ACRE-IN,421,2,8,3,46,136,90
PI475822C,2020,ACRE-IN,424,2,6,3,48,138,90
PI602450,2020,ACRE-IN,433,2,3,4,47,137,90
PI547876,2020,ACRE-IN,438,2,8,4,43,133,90
PI548603,2020,ACRE-IN,441,2,11,4,47,137,90
PI548340,2020,ACRE-IN,456,2,2,5,43,133,90
PI189935,2020,ACRE-IN,473,2,13,7,46,136,90
PI437388,2020,ACRE-IN,486,2,2,7,47,137,90
PI591530,2020,ACRE-IN,491,2,4,8,47,137,90
PI567527,2020,ACRE-IN,498,2,10,8,48,138,90
PI560206,2020,ACRE-IN,499,2,11,8,47,137,90
PI548602,2020,ACRE-IN,541,2,6,11,48,138,90
PI534648,2020,ACRE-IN,544,2,3,11,38,128,90
PI548250,2020,ACRE-IN,559,2,12,12,48,138,90
PI548549,2020,ACRE-IN,565,2,10,13,46,136,90
PI556857,2020,ACRE-IN,578,2,4,14,48,138,90
PI603564B,2020,ACRE-IN,592,2,12,15,48,138,90
PI602449,2020,ACRE-IN,608,2,4,16,47,137,90
PI614155,2020,ACRE-IN,34,1,6,4,42,133,91
PI556859,2020,ACRE-IN,52,1,7,5,42,133,91
PI591490,2020,ACRE-IN,89,1,5,7,47,138,91
PI560206,2020,ACRE-IN,122,1,2,9,47,138,91
PI636696,2020,ACRE-IN,175,1,6,13,47,138,91
PI518668,2020,ACRE-IN,190,1,8,14,47,138,91
PI437487,2020,ACRE-IN,305,1,10,22,42,133,91
PI248402,2020,ACRE-IN,320,1,6,23,47,138,91
PI597387,2020,ACRE-IN,333,1,6,24,45,136,91
PI636695,2020,ACRE-IN,334,1,7,24,48,139,91
PI547477,2020,ACRE-IN,444,2,13,5,46,137,91
PI577798,2020,ACRE-IN,474,2,12,7,46,137,91
PI567351B,2020,ACRE-IN,480,2,6,7,49,140,91
PI547497,2020,ACRE-IN,490,2,3,8,45,136,91
PI438252C,2020,ACRE-IN,494,2,7,8,43,134,91
PI153292,2020,ACRE-IN,561,2,13,12,38,129,91
PI548679,2020,ACRE-IN,570,2,5,13,47,138,91
PI548541,2020,ACRE-IN,575,2,1,14,48,139,91
PI437459,2020,ACRE-IN,583,2,9,14,44,135,91
PI543793,2020,ACRE-IN,602,2,3,15,46,137,91
PI576166,2020,ACRE-IN,603,2,2,15,47,138,91
PI548682,2020,ACRE-IN,612,2,8,16,46,137,91
PI548192,2020,ACRE-IN,646,2,12,18,45,136,91
PI548383,2020,ACRE-IN,670,2,7,20,42,133,91
PI590932,2020,ACRE-IN,675,2,12,20,47,138,91
PI548340,2020,ACRE-IN,38,1,10,4,NA,119,92
PI548286,2020,ACRE-IN,61,1,3,6,43,135,92
PI576166,2020,ACRE-IN,123,1,2,10,43,135,92
PI642055,2020,ACRE-IN,131,1,10,10,46,138,92
PI555396,2020,ACRE-IN,177,1,4,13,45,137,92
PI543793,2020,ACRE-IN,224,1,14,17,46,138,92
PI633732,2020,ACRE-IN,231,1,7,17,43,135,92
PI591521,2020,ACRE-IN,367,1,8,26,45,137,92
PI548339,2020,ACRE-IN,488,2,1,8,44,136,92
PI515961,2020,ACRE-IN,550,2,4,12,47,139,92
PI591490,2020,ACRE-IN,555,2,8,12,47,139,92
PI636696,2020,ACRE-IN,579,2,5,14,49,141,92
PI614155,2020,ACRE-IN,580,2,6,14,43,135,92
PI518668,2020,ACRE-IN,582,2,8,14,48,140,92
PI548410,2020,ACRE-IN,586,2,12,14,49,141,92
PI548670,2020,ACRE-IN,626,2,6,17,41,133,92
PI591537,2020,ACRE-IN,642,2,9,18,43,135,92
PI542043,2020,ACRE-IN,652,2,10,19,41,133,92
PI606748,2020,ACRE-IN,679,2,12,21,43,135,92
PI595363,2020,ACRE-IN,39,1,11,4,NA,120,93
PI556857,2020,ACRE-IN,67,1,8,6,44,137,93
PI547864,2020,ACRE-IN,161,1,9,12,44,137,93
PI534648,2020,ACRE-IN,176,1,5,13,38,131,93
PI189926,2020,ACRE-IN,276,1,11,20,43,136,93
PI591492,2020,ACRE-IN,435,2,5,4,43,136,93
PI424159B,2020,ACRE-IN,623,2,9,17,42,135,93
PI597387,2020,ACRE-IN,649,2,12,19,42,135,93
PI633732,2020,ACRE-IN,672,2,9,20,40,133,93
PI590932,2020,ACRE-IN,121,1,3,9,45,139,94
PI603454,2020,ACRE-IN,141,1,11,11,43,137,94
PI507696C,2020,ACRE-IN,375,1,14,27,43,137,94
PI538401B,2020,ACRE-IN,392,1,4,28,46,140,94
PI603564C,2020,ACRE-IN,673,2,10,20,43,137,94
PI591493,2020,ACRE-IN,468,2,9,6,42,137,95
PI606749,2020,ACRE-IN,393,1,5,28,43,140,97
PI556889,2020,ACRE-IN,503,2,13,8,43,140,97
PI438341,2020,ACRE-IN,92,1,2,7,38,137,99
PI153292,2020,ACRE-IN,214,1,6,16,38,138,100
PI552538,2020,ACRE-IN,309,1,14,22,NA,128,101
PI542043,2020,ACRE-IN,35,1,7,4,NA,129,102
PI591515,2020,ACRE-IN,36,1,8,4,NA,129,102
PI548242,2020,ACRE-IN,50,1,9,5,45,NA,NA
PI548679,2020,ACRE-IN,199,1,12,15,48,NA,NA
PI591498,2020,ACRE-IN,443,2,13,4,43,NA,NA
PI548597,2020,Gibson-IL,741,3,19,12,60,NA,NA
PI547811,2020,Gibson-IL,714,3,16,8,61,NA,NA
PI534645,2020,Gibson-IL,830,3,17,27,60,NA,NA
PI253661B,2020,Gibson-IL,144,1,2,25,74,145,71
PI253661B,2020,Gibson-IL,482,2,8,25,71,143,72
PI437903,2020,Gibson-IL,376,2,9,8,70,143,73
PI591532,2020,Gibson-IL,815,3,20,25,70,143,73
PI636696,2020,Gibson-IL,918,3,16,42,74,147,73
PI567366A,2020,Gibson-IL,33,1,4,24,68,143,75
PI437903,2020,Gibson-IL,38,1,8,24,68,143,75
PI438310,2020,Gibson-IL,418,2,12,15,68,143,75
PI548633,2020,Gibson-IL,941,3,15,46,68,143,75
PI603396,2020,Gibson-IL,5,1,5,22,68,144,76
PI437377,2020,Gibson-IL,477,2,13,25,66,143,77
PI437461,2020,Gibson-IL,757,3,18,15,66,143,77
PI437377,2020,Gibson-IL,809,3,15,24,66,143,77
PI170380,2020,Gibson-IL,921,3,19,42,66,143,77
PI548684,2020,Gibson-IL,978,3,16,52,68,145,77
PI427136,2020,Gibson-IL,122,1,3,22,65,143,78
PI438252C,2020,Gibson-IL,157,1,2,28,65,143,78
PI437550C,2020,Gibson-IL,480,2,10,25,66,144,78
PI507692B,2020,Gibson-IL,776,3,18,18,65,143,78
PI556778,2020,Gibson-IL,986,3,17,53,65,143,78
PI548366,2020,Gibson-IL,52,1,6,25,64,143,79
PI548267,2020,Gibson-IL,58,1,1,26,64,143,79
PI507692B,2020,Gibson-IL,104,1,6,19,64,143,79
PI437377,2020,Gibson-IL,139,1,7,25,64,143,79
PI437365,2020,Gibson-IL,361,2,9,5,64,143,79
PI548366,2020,Gibson-IL,390,2,11,10,64,143,79
PI437357,2020,Gibson-IL,414,2,11,14,64,143,79
PI507692B,2020,Gibson-IL,443,2,11,19,66,145,79
PI437103,2020,Gibson-IL,450,2,11,20,64,143,79
PI518673,2020,Gibson-IL,590,2,8,43,64,143,79
PI556778,2020,Gibson-IL,661,2,9,55,66,145,79
PI567366A,2020,Gibson-IL,708,3,19,7,74,153,79
PI437903,2020,Gibson-IL,712,3,15,7,64,143,79
PI548366,2020,Gibson-IL,727,3,17,10,64,143,79
PI437359,2020,Gibson-IL,748,3,15,13,64,143,79
PI438310,2020,Gibson-IL,752,3,18,14,64,143,79
PI548635,2020,Gibson-IL,759,3,16,15,64,143,79
PI437103,2020,Gibson-IL,783,3,16,19,64,143,79
PI548367,2020,Gibson-IL,785,3,15,20,64,143,79
PI253661B,2020,Gibson-IL,814,3,20,24,64,143,79
PI438486,2020,Gibson-IL,866,3,17,33,66,145,79
PI548686,2020,Gibson-IL,980,3,18,52,66,145,79
PI542709,2020,Gibson-IL,62,1,4,26,63,143,80
PI437641B,2020,Gibson-IL,91,1,4,28,63,143,80
PI548381,2020,Gibson-IL,95,1,8,28,63,143,80
PI547800,2020,Gibson-IL,156,1,2,27,65,145,80
PI404173B,2020,Gibson-IL,201,1,5,35,80,160,80
PI547800,2020,Gibson-IL,495,2,8,28,64,144,80
PI438409,2020,Gibson-IL,701,3,15,6,63,143,80
PI548180,2020,Gibson-IL,849,3,19,30,63,143,80
PI437365,2020,Gibson-IL,23,1,6,23,62,143,81
PI437422,2020,Gibson-IL,44,1,13,25,61,142,81
PI438310,2020,Gibson-IL,79,1,7,27,64,145,81
PI438079,2020,Gibson-IL,80,1,6,27,68,149,81
PI437467,2020,Gibson-IL,164,1,6,29,64,145,81
PI548340,2020,Gibson-IL,182,1,3,32,68,149,81
PI417573,2020,Gibson-IL,187,1,7,33,64,145,81
PI548633,2020,Gibson-IL,277,1,2,48,68,149,81
PI398881,2020,Gibson-IL,351,2,8,4,62,143,81
PI548635,2020,Gibson-IL,426,2,11,16,62,143,81
PI153243,2020,Gibson-IL,444,2,10,19,62,143,81
PI548684,2020,Gibson-IL,652,2,9,54,64,145,81
PI548686,2020,Gibson-IL,654,2,11,54,62,143,81
PI547814,2020,Gibson-IL,705,3,19,6,62,143,81
PI438079,2020,Gibson-IL,753,3,19,14,64,145,81
PI437550C,2020,Gibson-IL,812,3,18,24,62,143,81
PI547800,2020,Gibson-IL,825,3,19,26,64,145,81
PI595754,2020,Gibson-IL,2,1,2,22,61,143,82
PI437412,2020,Gibson-IL,20,1,9,23,62,144,82
PI438409,2020,Gibson-IL,25,1,4,23,61,143,82
PI547811,2020,Gibson-IL,40,1,10,24,60,142,82
PI552538,2020,Gibson-IL,42,1,12,24,62,144,82
PI437103,2020,Gibson-IL,111,1,4,20,62,144,82
PI437550C,2020,Gibson-IL,142,1,4,25,63,145,82
PI548204,2020,Gibson-IL,158,1,3,28,61,143,82
PI548546,2020,Gibson-IL,206,1,3,36,73,155,82
PI548532,2020,Gibson-IL,223,1,7,39,66,148,82
PI518673,2020,Gibson-IL,252,1,2,43,68,150,82
PI614154,2020,Gibson-IL,348,2,10,3,61,143,82
PI593463,2020,Gibson-IL,352,2,9,4,61,143,82
PI437412,2020,Gibson-IL,358,2,12,5,61,143,82
PI438409,2020,Gibson-IL,363,2,8,6,61,143,82
PI596407,2020,Gibson-IL,377,2,10,8,61,143,82
PI552538,2020,Gibson-IL,380,2,13,8,61,143,82
PI507676,2020,Gibson-IL,399,2,8,12,61,143,82
PI548367,2020,Gibson-IL,452,2,13,20,61,143,82
PI437467,2020,Gibson-IL,502,2,12,29,61,143,82
PI398881,2020,Gibson-IL,687,3,16,3,61,143,82
PI437412,2020,Gibson-IL,695,3,20,5,61,143,82
PI612932,2020,Gibson-IL,730,3,20,10,61,143,82
PI437357,2020,Gibson-IL,749,3,15,14,61,143,82
PI547798,2020,Gibson-IL,761,3,15,16,61,143,82
PI603434,2020,Gibson-IL,765,3,19,16,61,143,82
PI556989,2020,Gibson-IL,775,3,17,18,61,143,82
PI153243,2020,Gibson-IL,777,3,19,18,61,143,82
PI475822B,2020,Gibson-IL,823,3,17,26,61,143,82
PI438252C,2020,Gibson-IL,826,3,20,26,66,148,82
PI437467,2020,Gibson-IL,833,3,15,28,61,143,82
PI547663,2020,Gibson-IL,904,3,15,39,61,143,82
PI398881,2020,Gibson-IL,11,1,11,22,60,143,83
PI479740,2020,Gibson-IL,22,1,7,23,61,144,83
PI507676,2020,Gibson-IL,60,1,3,26,62,145,83
PI603434,2020,Gibson-IL,93,1,6,28,62,145,83
PI574532,2020,Gibson-IL,126,1,7,22,62,145,83
PI564718,2020,Gibson-IL,165,1,5,29,65,148,83
PI610670,2020,Gibson-IL,167,1,3,29,60,143,83
PI170380,2020,Gibson-IL,256,1,5,44,61,144,83
PI534647,2020,Gibson-IL,409,2,9,13,60,143,83
PI548381,2020,Gibson-IL,433,2,9,17,60,143,83
PI596407,2020,Gibson-IL,713,3,15,8,60,143,83
PI438124B,2020,Gibson-IL,732,3,19,11,60,143,83
PI591540,2020,Gibson-IL,789,3,19,20,60,143,83
PI634765,2020,Gibson-IL,801,3,19,22,60,143,83
PI548614,2020,Gibson-IL,802,3,20,22,60,143,83
PI417526,2020,Gibson-IL,4,1,4,22,59,143,84
PI548562,2020,Gibson-IL,6,1,6,22,57,141,84
PI437459,2020,Gibson-IL,7,1,7,22,60,144,84
PI153292,2020,Gibson-IL,24,1,5,23,58,142,84
PI437391,2020,Gibson-IL,49,1,9,25,61,145,84
PI591512,2020,Gibson-IL,51,1,7,25,62,146,84
PI437124,2020,Gibson-IL,56,1,2,25,60,144,84
PI438124B,2020,Gibson-IL,57,1,1,25,61,145,84
PI634762,2020,Gibson-IL,70,1,11,26,65,149,84
PI437359,2020,Gibson-IL,75,1,11,27,61,145,84
PI567404A,2020,Gibson-IL,107,1,3,19,64,148,84
PI438486,2020,Gibson-IL,197,1,6,34,61,145,84
PI548177,2020,Gibson-IL,240,1,2,41,61,145,84
PI283331,2020,Gibson-IL,370,2,12,7,69,153,84
PI438124B,2020,Gibson-IL,396,2,10,11,61,145,84
PI437317,2020,Gibson-IL,401,2,10,12,59,143,84
PI542044,2020,Gibson-IL,402,2,11,12,61,145,84
PI437359,2020,Gibson-IL,413,2,10,14,59,143,84
PI556989,2020,Gibson-IL,442,2,12,19,59,143,84
PI437392,2020,Gibson-IL,462,2,11,22,59,143,84
PI370055,2020,Gibson-IL,478,2,12,25,60,144,84
PI564718,2020,Gibson-IL,503,2,11,29,64,148,84
PI548632,2020,Gibson-IL,516,2,10,31,61,145,84
PI540555,2020,Gibson-IL,550,2,12,37,61,145,84
PI556928,2020,Gibson-IL,650,2,8,53,59,143,84
PI556816,2020,Gibson-IL,673,2,9,57,61,145,84
PI479740,2020,Gibson-IL,697,3,18,5,59,143,84
PI507708,2020,Gibson-IL,706,3,20,6,61,145,84
PI552538,2020,Gibson-IL,716,3,18,8,59,143,84
PI547801,2020,Gibson-IL,746,3,17,13,59,143,84
PI636464,2020,Gibson-IL,764,3,18,16,61,145,84
PI548381,2020,Gibson-IL,767,3,20,17,59,143,84
PI567404A,2020,Gibson-IL,780,3,19,19,67,151,84
PI437392,2020,Gibson-IL,795,3,16,21,59,143,84
PI603188,2020,Gibson-IL,803,3,20,23,61,145,84
PI548412,2020,Gibson-IL,850,3,20,30,61,145,84
PI547484,2020,Gibson-IL,874,3,20,34,61,145,84
PI548177,2020,Gibson-IL,907,3,17,40,66,150,84
PI556781,2020,Gibson-IL,990,3,16,54,61,145,84
PI556816,2020,Gibson-IL,998,3,17,55,61,145,84
PI593463,2020,Gibson-IL,12,1,12,22,59,144,85
PI547879,2020,Gibson-IL,13,1,13,22,66,151,85
PI591534,2020,Gibson-IL,43,1,13,24,57,142,85
PI548180,2020,Gibson-IL,180,1,2,31,58,143,85
PI437397,2020,Gibson-IL,245,1,6,42,68,153,85
PI548250,2020,Gibson-IL,283,1,7,49,77,162,85
PI548562,2020,Gibson-IL,345,2,13,3,58,143,85
PI567366A,2020,Gibson-IL,371,2,11,7,58,143,85
PI438341,2020,Gibson-IL,373,2,9,7,59,144,85
PI547811,2020,Gibson-IL,378,2,11,8,58,143,85
PI612932,2020,Gibson-IL,393,2,13,11,60,145,85
PI542709,2020,Gibson-IL,400,2,9,12,60,145,85
PI437461,2020,Gibson-IL,424,2,9,16,66,151,85
PI574532,2020,Gibson-IL,465,2,13,23,58,143,85
PI438252C,2020,Gibson-IL,496,2,9,28,64,149,85
PI548525,2020,Gibson-IL,509,2,10,30,68,153,85
PI404173B,2020,Gibson-IL,538,2,12,35,78,163,85
PI548633,2020,Gibson-IL,615,2,8,48,67,152,85
PI548670,2020,Gibson-IL,658,2,12,55,68,153,85
PI518675,2020,Gibson-IL,677,3,15,2,58,143,85
PI603442,2020,Gibson-IL,694,3,20,4,58,143,85
PI283331,2020,Gibson-IL,707,3,20,7,64,149,85
PI438341,2020,Gibson-IL,710,3,17,7,58,143,85
PI634761,2020,Gibson-IL,786,3,16,20,64,149,85
PI603428D,2020,Gibson-IL,794,3,17,21,64,149,85
PI564718,2020,Gibson-IL,834,3,16,28,66,151,85
PI591513,2020,Gibson-IL,3,1,3,22,64,150,86
PI547814,2020,Gibson-IL,30,1,1,24,58,144,86
PI507708,2020,Gibson-IL,31,1,2,24,59,145,86
PI547847,2020,Gibson-IL,34,1,5,24,66,152,86
PI438341,2020,Gibson-IL,35,1,6,24,58,144,86
PI596407,2020,Gibson-IL,39,1,9,24,59,145,86
PI612932,2020,Gibson-IL,55,1,3,25,57,143,86
PI595926,2020,Gibson-IL,59,1,2,26,57,143,86
PI542044,2020,Gibson-IL,64,1,6,26,62,148,86
PI534647,2020,Gibson-IL,71,1,12,26,59,145,86
PI548635,2020,Gibson-IL,86,1,1,28,65,151,86
PI591531,2020,Gibson-IL,90,1,3,28,62,148,86
PI153243,2020,Gibson-IL,105,1,5,19,63,149,86
PI475822B,2020,Gibson-IL,153,1,5,27,57,143,86
PI548525,2020,Gibson-IL,171,1,4,30,65,151,86
PI561330A,2020,Gibson-IL,176,1,6,31,57,143,86
PI209331,2020,Gibson-IL,185,1,6,32,57,143,86
PI438500,2020,Gibson-IL,354,2,11,4,57,143,86
PI603442,2020,Gibson-IL,357,2,13,5,57,143,86
PI153292,2020,Gibson-IL,362,2,8,5,59,145,86
PI586980,2020,Gibson-IL,366,2,11,6,57,143,86
PI475822C,2020,Gibson-IL,375,2,8,8,77,163,86
PI614832,2020,Gibson-IL,379,2,12,8,59,145,86
PI591534,2020,Gibson-IL,381,2,13,9,57,143,86
PI437422,2020,Gibson-IL,382,2,12,9,58,144,86
PI437463B,2020,Gibson-IL,383,2,11,9,57,143,86
PI437124,2020,Gibson-IL,394,2,12,11,57,143,86
PI595926,2020,Gibson-IL,398,2,8,11,57,143,86
PI548597,2020,Gibson-IL,406,2,12,13,57,143,86
PI438079,2020,Gibson-IL,419,2,11,15,66,152,86
PI437641B,2020,Gibson-IL,429,2,13,17,57,143,86
PI636464,2020,Gibson-IL,430,2,12,17,57,143,86
PI603434,2020,Gibson-IL,431,2,11,17,57,143,86
PI437500C,2020,Gibson-IL,439,2,12,18,57,143,86
PI437500B,2020,Gibson-IL,457,2,9,21,57,143,86
PI603428D,2020,Gibson-IL,461,2,10,22,57,143,86
PI603193,2020,Gibson-IL,479,2,11,25,59,145,86
PI548180,2020,Gibson-IL,518,2,8,31,57,143,86
PI603571B,2020,Gibson-IL,579,2,8,42,67,153,86
PI602449,2020,Gibson-IL,614,2,8,47,67,153,86
PI556687,2020,Gibson-IL,660,2,10,55,59,145,86
PI548562,2020,Gibson-IL,682,3,20,2,57,143,86
PI591534,2020,Gibson-IL,717,3,19,8,57,143,86
PI437124,2020,Gibson-IL,731,3,20,11,57,143,86
PI507676,2020,Gibson-IL,735,3,16,11,57,143,86
PI534647,2020,Gibson-IL,744,3,19,13,57,143,86
PI253660A,2020,Gibson-IL,754,3,20,14,57,143,86
PI548542,2020,Gibson-IL,756,3,19,15,57,143,86
PI437641B,2020,Gibson-IL,763,3,17,16,57,143,86
PI437500C,2020,Gibson-IL,773,3,15,18,57,143,86
PI437500B,2020,Gibson-IL,790,3,20,20,57,143,86
PI437338,2020,Gibson-IL,819,3,16,25,59,145,86
PI561330A,2020,Gibson-IL,844,3,15,29,57,143,86
PI547617,2020,Gibson-IL,932,3,18,44,71,157,86
PI438500,2020,Gibson-IL,14,1,13,23,57,144,87
PI603442,2020,Gibson-IL,19,1,10,23,58,145,87
PI586980,2020,Gibson-IL,29,1,1,23,57,144,87
PI614832,2020,Gibson-IL,41,1,11,24,57,144,87
PI438357B,2020,Gibson-IL,47,1,10,25,66,153,87
PI591509,2020,Gibson-IL,74,1,12,27,64,151,87
PI437357,2020,Gibson-IL,76,1,10,27,62,149,87
PI437461,2020,Gibson-IL,84,1,2,27,65,152,87
PI547798,2020,Gibson-IL,88,1,2,28,62,149,87
PI591504,2020,Gibson-IL,99,1,4,18,68,155,87
PI437500C,2020,Gibson-IL,101,1,6,18,56,143,87
PI556989,2020,Gibson-IL,103,1,7,19,57,144,87
PI548367,2020,Gibson-IL,114,1,7,20,59,146,87
PI437392,2020,Gibson-IL,124,1,5,22,56,143,87
PI603188,2020,Gibson-IL,132,1,2,23,65,152,87
PI437894,2020,Gibson-IL,148,1,5,26,58,145,87
PI548632,2020,Gibson-IL,178,1,4,31,62,149,87
PI592946,2020,Gibson-IL,209,1,6,36,68,155,87
PI555399,2020,Gibson-IL,210,1,7,36,70,157,87
PI603205,2020,Gibson-IL,224,1,6,39,65,152,87
PI603396,2020,Gibson-IL,344,2,13,2,68,155,87
PI591503,2020,Gibson-IL,455,2,11,21,61,148,87
PI534645,2020,Gibson-IL,499,2,12,28,56,143,87
PI561330A,2020,Gibson-IL,514,2,12,31,56,143,87
PI438486,2020,Gibson-IL,535,2,12,34,62,149,87
PI602450,2020,Gibson-IL,586,2,12,43,64,151,87
PI548247,2020,Gibson-IL,600,2,10,45,64,151,87
PI548518,2020,Gibson-IL,619,2,12,48,56,143,87
PI548194,2020,Gibson-IL,640,2,9,52,70,157,87
PI548373,2020,Gibson-IL,684,3,19,3,66,153,87
PI475822C,2020,Gibson-IL,711,3,16,7,75,162,87
PI595926,2020,Gibson-IL,734,3,17,11,56,143,87
PI548365,2020,Gibson-IL,745,3,18,13,61,148,87
PI548333,2020,Gibson-IL,766,3,20,16,61,148,87
PI547869,2020,Gibson-IL,779,3,20,19,61,148,87
PI427136,2020,Gibson-IL,793,3,18,21,66,153,87
PI574532,2020,Gibson-IL,797,3,15,22,62,149,87
PI548558,2020,Gibson-IL,817,3,18,25,58,145,87
PI610670,2020,Gibson-IL,836,3,18,28,61,148,87
PI548525,2020,Gibson-IL,840,3,19,29,66,153,87
PI603186,2020,Gibson-IL,843,3,16,29,66,153,87
PI424405A,2020,Gibson-IL,846,3,16,30,61,148,87
PI548340,2020,Gibson-IL,851,3,20,31,64,151,87
PI548304,2020,Gibson-IL,864,3,19,33,56,143,87
PI592946,2020,Gibson-IL,876,3,19,35,68,155,87
PI602450,2020,Gibson-IL,914,3,17,41,68,155,87
PI518673,2020,Gibson-IL,917,3,15,42,68,155,87
PI548410,2020,Gibson-IL,930,3,16,44,68,155,87
PI556511,2020,Gibson-IL,1000,3,15,55,56,143,87
PI548373,2020,Gibson-IL,8,1,8,22,61,149,88
PI437463B,2020,Gibson-IL,45,1,12,25,55,143,88
PI591506,2020,Gibson-IL,50,1,8,25,56,144,88
PI547801,2020,Gibson-IL,73,1,13,27,57,145,88
PI615555,2020,Gibson-IL,77,1,9,27,62,150,88
PI548542,2020,Gibson-IL,83,1,3,27,62,150,88
PI636464,2020,Gibson-IL,92,1,5,28,62,150,88
PI547886,2020,Gibson-IL,97,1,2,18,65,153,88
PI591507,2020,Gibson-IL,102,1,7,18,64,152,88
PI591517,2020,Gibson-IL,112,1,5,20,61,149,88
PI437500B,2020,Gibson-IL,119,1,3,21,62,150,88
PI603428D,2020,Gibson-IL,123,1,4,22,57,145,88
PI189928,2020,Gibson-IL,173,1,6,30,57,145,88
PI548304,2020,Gibson-IL,195,1,4,34,57,145,88
PI533654,2020,Gibson-IL,205,1,2,36,63,151,88
PI548174,2020,Gibson-IL,226,1,4,39,60,148,88
PI547655,2020,Gibson-IL,229,1,2,40,61,149,88
PI591498,2020,Gibson-IL,251,1,3,43,61,149,88
PI602449,2020,Gibson-IL,276,1,2,47,69,157,88
PI548222,2020,Gibson-IL,289,1,2,50,61,149,88
PI548603,2020,Gibson-IL,298,1,4,51,73,161,88
PI556931,2020,Gibson-IL,333,1,5,57,57,145,88
PI518675,2020,Gibson-IL,339,2,8,2,55,143,88
PI479740,2020,Gibson-IL,360,2,10,5,57,145,88
PI591506,2020,Gibson-IL,388,2,9,10,55,143,88
PI615555,2020,Gibson-IL,415,2,12,14,57,145,88
PI567404A,2020,Gibson-IL,446,2,8,19,67,155,88
PI603188,2020,Gibson-IL,471,2,8,24,64,152,88
PI612750,2020,Gibson-IL,522,2,11,32,55,143,88
PI592946,2020,Gibson-IL,546,2,11,36,69,157,88
PI547655,2020,Gibson-IL,566,2,8,39,57,145,88
PI548231,2020,Gibson-IL,572,2,13,40,55,143,88
PI548177,2020,Gibson-IL,578,2,8,41,61,149,88
PI548339,2020,Gibson-IL,622,2,12,49,69,157,88
PI576160,2020,Gibson-IL,649,2,9,53,57,145,88
PI603396,2020,Gibson-IL,681,3,19,2,65,153,88
PI614154,2020,Gibson-IL,685,3,18,3,55,143,88
PI437365,2020,Gibson-IL,698,3,17,5,63,151,88
PI591533,2020,Gibson-IL,702,3,16,6,60,148,88
PI437422,2020,Gibson-IL,718,3,20,8,57,145,88
PI437463B,2020,Gibson-IL,719,3,20,9,55,143,88
PI591506,2020,Gibson-IL,724,3,15,9,55,143,88
PI591512,2020,Gibson-IL,726,3,16,10,61,149,88
PI547813,2020,Gibson-IL,739,3,17,12,64,152,88
PI548242,2020,Gibson-IL,787,3,17,20,61,149,88
PI591503,2020,Gibson-IL,788,3,18,20,61,149,88
PI548632,2020,Gibson-IL,847,3,17,30,57,145,88
PI561321,2020,Gibson-IL,863,3,20,33,55,143,88
PI593654,2020,Gibson-IL,906,3,16,40,55,143,88
PI548400,2020,Gibson-IL,909,3,19,40,67,155,88
PI437397,2020,Gibson-IL,911,3,20,41,66,154,88
PI556931,2020,Gibson-IL,995,3,20,55,55,143,88
PI548685,2020,Gibson-IL,996,3,19,55,55,143,88
PI518675,2020,Gibson-IL,1,1,1,22,54,143,89
PI614154,2020,Gibson-IL,9,1,9,22,55,144,89
PI437388,2020,Gibson-IL,21,1,8,23,60,149,89
PI591533,2020,Gibson-IL,26,1,3,23,61,150,89
PI283331,2020,Gibson-IL,32,1,3,24,62,151,89
PI547876,2020,Gibson-IL,53,1,5,25,61,150,89
PI591528,2020,Gibson-IL,69,1,10,26,57,146,89
PI634763,2020,Gibson-IL,98,1,3,18,67,156,89
PI634761,2020,Gibson-IL,115,1,7,21,62,151,89
PI591540,2020,Gibson-IL,118,1,4,21,60,149,89
PI189935,2020,Gibson-IL,155,1,3,27,65,154,89
PI603186,2020,Gibson-IL,175,1,7,31,61,150,89
PI437444,2020,Gibson-IL,192,1,2,33,63,152,89
PI547500,2020,Gibson-IL,204,1,2,35,62,151,89
PI548678,2020,Gibson-IL,225,1,5,39,77,166,89
PI548231,2020,Gibson-IL,234,1,7,40,55,144,89
PI547663,2020,Gibson-IL,237,1,5,41,56,145,89
PI603571B,2020,Gibson-IL,242,1,3,42,66,155,89
PI548400,2020,Gibson-IL,243,1,4,42,66,155,89
PI548518,2020,Gibson-IL,281,1,6,48,56,145,89
PI548339,2020,Gibson-IL,284,1,6,49,71,160,89
PI548297,2020,Gibson-IL,288,1,2,49,71,160,89
PI603201,2020,Gibson-IL,297,1,5,51,78,167,89
PI507708,2020,Gibson-IL,369,2,13,7,62,151,89
PI591540,2020,Gibson-IL,456,2,10,21,59,148,89
PI427136,2020,Gibson-IL,460,2,9,22,66,155,89
PI548286,2020,Gibson-IL,473,2,10,24,64,153,89
PI547802,2020,Gibson-IL,476,2,13,24,62,151,89
PI548340,2020,Gibson-IL,521,2,10,32,62,151,89
PI548400,2020,Gibson-IL,580,2,9,42,64,153,89
PI437397,2020,Gibson-IL,583,2,12,42,66,155,89
PI170380,2020,Gibson-IL,594,2,11,44,64,153,89
PI556931,2020,Gibson-IL,670,2,12,57,56,145,89
PI556511,2020,Gibson-IL,674,2,8,57,55,144,89
PI547879,2020,Gibson-IL,690,3,16,4,68,157,89
PI548267,2020,Gibson-IL,733,3,18,11,64,153,89
PI542709,2020,Gibson-IL,736,3,15,11,61,150,89
PI634762,2020,Gibson-IL,743,3,20,13,66,155,89
PI547802,2020,Gibson-IL,808,3,15,23,64,153,89
PI417573,2020,Gibson-IL,855,3,16,31,64,153,89
PI547864,2020,Gibson-IL,859,3,17,32,61,150,89
PI547500,2020,Gibson-IL,871,3,17,34,64,153,89
PI533654,2020,Gibson-IL,872,3,18,34,64,153,89
PI548194,2020,Gibson-IL,965,3,15,50,71,160,89
PI556932,2020,Gibson-IL,974,3,17,51,69,158,89
PI584441,2020,Gibson-IL,16,1,12,23,60,150,90
PI591505,2020,Gibson-IL,78,1,8,27,65,155,90
PI548383,2020,Gibson-IL,120,1,2,21,61,151,90
PI548585,2020,Gibson-IL,196,1,5,34,61,151,90
PI248402,2020,Gibson-IL,208,1,5,36,71,161,90
PI636696,2020,Gibson-IL,253,1,2,44,74,164,90
PI591497,2020,Gibson-IL,266,1,3,46,61,151,90
PI548191,2020,Gibson-IL,282,1,7,48,71,161,90
PI518663,2020,Gibson-IL,293,1,6,50,55,145,90
PI556932,2020,Gibson-IL,310,1,4,53,73,163,90
PI548686,2020,Gibson-IL,317,1,6,54,67,157,90
PI591512,2020,Gibson-IL,389,2,10,10,61,151,90
PI548542,2020,Gibson-IL,422,2,8,15,59,149,90
PI548242,2020,Gibson-IL,454,2,12,21,61,151,90
PI475822B,2020,Gibson-IL,492,2,10,27,55,145,90
PI548304,2020,Gibson-IL,533,2,10,34,59,149,90
PI547500,2020,Gibson-IL,540,2,10,35,61,151,90
PI547484,2020,Gibson-IL,544,2,9,36,61,151,90
PI603564B,2020,Gibson-IL,556,2,9,38,71,161,90
PI547663,2020,Gibson-IL,575,2,11,41,55,145,90
PI593654,2020,Gibson-IL,577,2,9,41,55,145,90
PI591498,2020,Gibson-IL,589,2,9,43,61,151,90
PI591497,2020,Gibson-IL,604,2,9,46,59,149,90
PI547501,2020,Gibson-IL,624,2,10,49,55,145,90
PI548603,2020,Gibson-IL,637,2,9,51,73,163,90
PI548517,2020,Gibson-IL,641,2,10,52,72,162,90
PI576166,2020,Gibson-IL,667,2,12,56,67,157,90
PI548685,2020,Gibson-IL,671,2,11,57,59,149,90
PI542044,2020,Gibson-IL,738,3,16,12,61,151,90
PI591531,2020,Gibson-IL,762,3,16,16,61,151,90
PI555396,2020,Gibson-IL,782,3,17,19,67,157,90
PI542711,2020,Gibson-IL,804,3,19,23,59,149,90
PI548286,2020,Gibson-IL,805,3,18,23,62,152,90
PI370055,2020,Gibson-IL,810,3,16,24,61,151,90
PI548652,2020,Gibson-IL,813,3,19,24,58,148,90
PI547885,2020,Gibson-IL,822,3,16,26,63,153,90
PI437487,2020,Gibson-IL,867,3,16,33,62,152,90
PI548636,2020,Gibson-IL,910,3,20,40,68,158,90
PI591495,2020,Gibson-IL,913,3,18,41,70,160,90
PI602449,2020,Gibson-IL,940,3,15,45,68,158,90
PI548193,2020,Gibson-IL,963,3,16,49,70,160,90
PI556928,2020,Gibson-IL,976,3,15,51,64,154,90
PI437367,2020,Gibson-IL,10,1,10,22,60,151,91
PI591535,2020,Gibson-IL,46,1,11,25,60,151,91
PI591530,2020,Gibson-IL,85,1,1,27,64,155,91
PI547869,2020,Gibson-IL,106,1,4,19,62,153,91
PI591503,2020,Gibson-IL,117,1,5,21,64,155,91
PI548614,2020,Gibson-IL,131,1,3,23,61,152,91
PI603193,2020,Gibson-IL,141,1,5,25,64,155,91
PI591526,2020,Gibson-IL,179,1,3,31,62,153,91
PI547864,2020,Gibson-IL,190,1,4,33,61,152,91
PI189926,2020,Gibson-IL,211,1,7,37,63,154,91
PI540555,2020,Gibson-IL,212,1,6,37,61,152,91
PI371611,2020,Gibson-IL,238,1,4,41,63,154,91
PI593654,2020,Gibson-IL,239,1,3,41,57,148,91
PI603454,2020,Gibson-IL,295,1,7,51,64,155,91
PI556778,2020,Gibson-IL,323,1,3,55,66,157,91
PI591533,2020,Gibson-IL,364,2,9,6,59,150,91
PI547814,2020,Gibson-IL,367,2,12,6,57,148,91
PI634763,2020,Gibson-IL,436,2,9,18,66,157,91
PI548262,2020,Gibson-IL,459,2,8,22,64,155,91
PI591519,2020,Gibson-IL,466,2,12,23,61,152,91
PI548652,2020,Gibson-IL,481,2,9,25,61,152,91
PI424405A,2020,Gibson-IL,515,2,11,31,57,148,91
PI417573,2020,Gibson-IL,525,2,13,33,59,150,91
PI603454,2020,Gibson-IL,634,2,12,51,64,155,91
PI437711B,2020,Gibson-IL,646,2,12,53,71,162,91
PI548671,2020,Gibson-IL,666,2,11,56,69,160,91
PI438500,2020,Gibson-IL,691,3,17,4,62,153,91
PI614832,2020,Gibson-IL,715,3,17,8,60,151,91
PI615555,2020,Gibson-IL,750,3,16,14,61,152,91
PI591504,2020,Gibson-IL,771,3,16,17,66,157,91
PI591517,2020,Gibson-IL,784,3,15,19,64,155,91
PI534648,2020,Gibson-IL,816,3,19,25,57,148,91
PI437444,2020,Gibson-IL,861,3,19,32,62,153,91
PI603205,2020,Gibson-IL,890,3,17,37,64,155,91
PI547655,2020,Gibson-IL,895,3,17,38,62,153,91
PI548247,2020,Gibson-IL,928,3,15,43,62,153,91
PI603915D,2020,Gibson-IL,934,3,20,44,64,155,91
PI567527,2020,Gibson-IL,936,3,19,45,69,160,91
PI595363,2020,Gibson-IL,938,3,17,45,60,151,91
PI548250,2020,Gibson-IL,947,3,20,47,71,162,91
PI548517,2020,Gibson-IL,967,3,17,50,70,161,91
PI548679,2020,Gibson-IL,993,3,19,54,69,160,91
PI437464,2020,Gibson-IL,27,1,2,23,59,151,92
PI437317,2020,Gibson-IL,63,1,5,26,58,150,92
PI548365,2020,Gibson-IL,72,1,13,26,59,151,92
PI548333,2020,Gibson-IL,94,1,7,28,57,149,92
PI548242,2020,Gibson-IL,116,1,6,21,61,153,92
PI548286,2020,Gibson-IL,134,1,3,24,61,153,92
PI548558,2020,Gibson-IL,147,1,4,26,61,153,92
PI547860,2020,Gibson-IL,150,1,7,26,64,156,92
PI547885,2020,Gibson-IL,152,1,6,27,65,157,92
PI534645,2020,Gibson-IL,160,1,5,28,57,149,92
PI424405A,2020,Gibson-IL,177,1,5,31,57,149,92
PI612750,2020,Gibson-IL,183,1,4,32,57,149,92
PI561321,2020,Gibson-IL,194,1,3,34,57,149,92
PI437487,2020,Gibson-IL,199,1,7,35,61,153,92
PI615556,2020,Gibson-IL,213,1,5,37,61,153,92
PI548547,2020,Gibson-IL,230,1,3,40,61,153,92
PI424405B,2020,Gibson-IL,246,1,7,42,63,155,92
PI567767B,2020,Gibson-IL,254,1,3,44,64,156,92
PI432359,2020,Gibson-IL,272,1,6,47,65,157,92
PI595363,2020,Gibson-IL,273,1,5,47,59,151,92
PI547657,2020,Gibson-IL,287,1,3,49,68,160,92
PI525454,2020,Gibson-IL,300,1,2,51,68,160,92
PI417526,2020,Gibson-IL,343,2,12,2,59,151,92
PI548267,2020,Gibson-IL,397,2,9,11,66,158,92
PI253660A,2020,Gibson-IL,420,2,10,15,57,149,92
PI547798,2020,Gibson-IL,427,2,12,16,57,149,92
PI591531,2020,Gibson-IL,428,2,13,16,59,151,92
PI591517,2020,Gibson-IL,451,2,12,20,63,155,92
PI548383,2020,Gibson-IL,458,2,8,21,61,153,92
PI548614,2020,Gibson-IL,470,2,8,23,61,153,92
PI548558,2020,Gibson-IL,486,2,11,26,57,149,92
PI610670,2020,Gibson-IL,505,2,9,29,57,149,92
PI567351B,2020,Gibson-IL,506,2,8,29,71,163,92
PI548412,2020,Gibson-IL,520,2,9,32,57,149,92
PI591510,2020,Gibson-IL,523,2,12,32,61,153,92
PI437444,2020,Gibson-IL,530,2,8,33,59,151,92
PI548585,2020,Gibson-IL,534,2,11,34,57,149,92
PI189926,2020,Gibson-IL,549,2,13,37,63,155,92
PI591494,2020,Gibson-IL,552,2,10,37,68,160,92
PI567767B,2020,Gibson-IL,592,2,9,44,61,153,92
PI548410,2020,Gibson-IL,602,2,8,45,69,161,92
PI548191,2020,Gibson-IL,620,2,13,48,68,160,92
PI547545,2020,Gibson-IL,630,2,11,50,63,155,92
PI556781,2020,Gibson-IL,665,2,10,56,57,149,92
PI417526,2020,Gibson-IL,680,3,18,2,60,152,92
PI437391,2020,Gibson-IL,723,3,16,9,62,154,92
PI634763,2020,Gibson-IL,770,3,17,17,66,158,92
PI437894,2020,Gibson-IL,818,3,17,25,60,152,92
PI548421,2020,Gibson-IL,831,3,16,27,61,153,92
PI542043,2020,Gibson-IL,862,3,20,32,61,153,92
PI548546,2020,Gibson-IL,873,3,19,34,68,160,92
PI603564A,2020,Gibson-IL,898,3,20,38,60,152,92
PI548191,2020,Gibson-IL,946,3,20,46,68,160,92
PI548297,2020,Gibson-IL,952,3,15,47,69,161,92
PI548603,2020,Gibson-IL,962,3,17,49,69,161,92
PI633729,2020,Gibson-IL,17,1,11,23,58,151,93
PI475822C,2020,Gibson-IL,37,1,7,24,69,162,93
PI634764,2020,Gibson-IL,108,1,2,19,64,157,93
PI548275,2020,Gibson-IL,135,1,4,24,62,155,93
PI547802,2020,Gibson-IL,138,1,7,24,62,155,93
PI548652,2020,Gibson-IL,143,1,3,25,57,150,93
PI591532,2020,Gibson-IL,145,1,2,26,62,155,93
PI437338,2020,Gibson-IL,149,1,6,26,56,149,93
PI591538,2020,Gibson-IL,169,1,2,30,57,150,93
PI574534,2020,Gibson-IL,188,1,6,33,58,151,93
PI547501,2020,Gibson-IL,286,1,4,49,55,148,93
PI548192,2020,Gibson-IL,306,1,7,52,64,157,93
PI548670,2020,Gibson-IL,320,1,6,55,64,157,93
PI556816,2020,Gibson-IL,336,1,2,57,68,161,93
PI595754,2020,Gibson-IL,340,2,9,2,59,152,93
PI547879,2020,Gibson-IL,353,2,10,4,67,160,93
PI591535,2020,Gibson-IL,384,2,10,9,64,157,93
PI548333,2020,Gibson-IL,432,2,10,17,58,151,93
PI634764,2020,Gibson-IL,448,2,9,20,64,157,93
PI548275,2020,Gibson-IL,474,2,11,24,62,155,93
PI534648,2020,Gibson-IL,485,2,10,26,56,149,93
PI591516,2020,Gibson-IL,501,2,13,29,64,157,93
PI542043,2020,Gibson-IL,531,2,8,34,62,155,93
PI437487,2020,Gibson-IL,536,2,13,34,62,155,93
PI603205,2020,Gibson-IL,561,2,13,39,64,157,93
PI548678,2020,Gibson-IL,562,2,12,39,74,167,93
PI548636,2020,Gibson-IL,582,2,11,42,67,160,93
PI636696,2020,Gibson-IL,591,2,8,44,75,168,93
PI614155,2020,Gibson-IL,598,2,12,45,62,155,93
PI547617,2020,Gibson-IL,605,2,10,46,67,160,93
PI548250,2020,Gibson-IL,621,2,13,49,74,167,93
PI548549,2020,Gibson-IL,629,2,10,50,64,157,93
PI556932,2020,Gibson-IL,648,2,10,53,69,162,93
PI556814,2020,Gibson-IL,653,2,10,54,64,157,93
PI595754,2020,Gibson-IL,678,3,16,2,61,154,93
PI437459,2020,Gibson-IL,683,3,20,3,61,154,93
PI586980,2020,Gibson-IL,704,3,18,6,60,153,93
PI547847,2020,Gibson-IL,709,3,18,7,64,157,93
PI614153,2020,Gibson-IL,821,3,15,26,60,153,93
PI591521,2020,Gibson-IL,828,3,19,27,64,157,93
PI603564B,2020,Gibson-IL,886,3,20,36,68,161,93
PI567767B,2020,Gibson-IL,919,3,17,42,64,157,93
PI547471,2020,Gibson-IL,920,3,18,42,68,161,93
PI614155,2020,Gibson-IL,926,3,17,43,61,154,93
PI642055,2020,Gibson-IL,942,3,16,46,74,167,93
PI548670,2020,Gibson-IL,983,3,20,53,57,150,93
PI556859,2020,Gibson-IL,987,3,16,53,62,155,93
PI576166,2020,Gibson-IL,992,3,18,54,67,160,93
PI548262,2020,Gibson-IL,121,1,2,22,61,155,94
PI370055,2020,Gibson-IL,140,1,6,25,59,153,94
PI534648,2020,Gibson-IL,146,1,3,26,57,151,94
PI548421,2020,Gibson-IL,161,1,6,28,59,153,94
PI591510,2020,Gibson-IL,184,1,5,32,61,155,94
PI593258,2020,Gibson-IL,191,1,3,33,61,155,94
PI542043,2020,Gibson-IL,193,1,2,34,63,157,94
PI547598,2020,Gibson-IL,236,1,6,41,61,155,94
PI548636,2020,Gibson-IL,244,1,5,42,68,162,94
PI602450,2020,Gibson-IL,248,1,6,43,61,155,94
PI548602,2020,Gibson-IL,279,1,4,48,73,167,94
PI547497,2020,Gibson-IL,280,1,5,48,62,156,94
PI548517,2020,Gibson-IL,303,1,4,52,69,163,94
PI556687,2020,Gibson-IL,322,1,4,55,59,153,94
PI437367,2020,Gibson-IL,350,2,8,3,64,158,94
PI437391,2020,Gibson-IL,387,2,8,10,62,156,94
PI591528,2020,Gibson-IL,407,2,11,13,64,158,94
PI591509,2020,Gibson-IL,412,2,9,14,64,158,94
PI547869,2020,Gibson-IL,445,2,9,19,61,155,94
PI634761,2020,Gibson-IL,453,2,13,21,58,152,94
PI542711,2020,Gibson-IL,472,2,9,24,57,151,94
PI574534,2020,Gibson-IL,526,2,12,33,57,151,94
PI248402,2020,Gibson-IL,545,2,10,36,70,164,94
PI615556,2020,Gibson-IL,551,2,11,37,59,153,94
PI567527,2020,Gibson-IL,609,2,13,47,69,163,94
PI548602,2020,Gibson-IL,617,2,10,48,75,169,94
PI548193,2020,Gibson-IL,638,2,8,51,66,160,94
PI525454,2020,Gibson-IL,639,2,8,52,67,161,94
PI556859,2020,Gibson-IL,662,2,8,55,63,157,94
PI593463,2020,Gibson-IL,688,3,15,3,61,155,94
PI153292,2020,Gibson-IL,700,3,15,5,59,153,94
PI437317,2020,Gibson-IL,737,3,15,12,57,151,94
PI591528,2020,Gibson-IL,742,3,20,12,61,155,94
PI548262,2020,Gibson-IL,792,3,19,21,61,155,94
PI548204,2020,Gibson-IL,827,3,20,27,57,151,94
PI567351B,2020,Gibson-IL,837,3,19,28,69,163,94
PI591538,2020,Gibson-IL,838,3,20,28,61,155,94
PI591539,2020,Gibson-IL,842,3,17,29,63,157,94
PI591526,2020,Gibson-IL,848,3,18,30,64,158,94
PI612750,2020,Gibson-IL,852,3,19,31,55,149,94
PI548585,2020,Gibson-IL,865,3,18,33,58,152,94
PI404173B,2020,Gibson-IL,869,3,15,34,68,162,94
PI636695,2020,Gibson-IL,887,3,20,37,66,160,94
PI548532,2020,Gibson-IL,889,3,18,37,66,160,94
PI548174,2020,Gibson-IL,892,3,15,37,61,155,94
PI538401B,2020,Gibson-IL,894,3,16,38,61,155,94
PI548547,2020,Gibson-IL,896,3,18,38,61,155,94
PI577798,2020,Gibson-IL,915,3,16,41,68,162,94
PI591498,2020,Gibson-IL,916,3,15,41,61,155,94
PI603564C,2020,Gibson-IL,922,3,20,42,69,163,94
PI591493,2020,Gibson-IL,935,3,20,45,64,158,94
PI437711B,2020,Gibson-IL,972,3,19,51,66,160,94
PI556572,2020,Gibson-IL,982,3,20,52,64,158,94
PI568245,2020,Gibson-IL,994,3,20,54,61,155,94
PI591515,2020,Gibson-IL,54,1,4,25,56,151,95
PI548597,2020,Gibson-IL,68,1,9,26,58,153,95
PI253660A,2020,Gibson-IL,81,1,5,27,57,152,95
PI555396,2020,Gibson-IL,110,1,3,20,65,160,95
PI542711,2020,Gibson-IL,133,1,2,24,57,152,95
PI603564A,2020,Gibson-IL,232,1,5,40,55,150,95
PI547471,2020,Gibson-IL,255,1,4,44,66,161,95
PI614155,2020,Gibson-IL,260,1,6,45,58,153,95
PI548247,2020,Gibson-IL,262,1,4,45,60,155,95
PI591493,2020,Gibson-IL,270,1,7,46,65,160,95
PI518668,2020,Gibson-IL,275,1,3,47,69,164,95
PI642055,2020,Gibson-IL,278,1,3,48,70,165,95
PI548613,2020,Gibson-IL,285,1,5,49,55,150,95
PI593256,2020,Gibson-IL,296,1,6,51,67,162,95
PI548194,2020,Gibson-IL,302,1,3,52,65,160,95
PI591499,2020,Gibson-IL,307,1,7,53,62,157,95
PI556857,2020,Gibson-IL,313,1,2,54,66,161,95
PI548684,2020,Gibson-IL,314,1,3,54,67,162,95
PI556814,2020,Gibson-IL,315,1,4,54,68,163,95
PI548679,2020,Gibson-IL,330,1,7,56,72,167,95
PI591513,2020,Gibson-IL,341,2,10,2,62,157,95
PI547801,2020,Gibson-IL,411,2,8,14,57,152,95
PI574541,2020,Gibson-IL,438,2,11,18,59,154,95
PI437338,2020,Gibson-IL,488,2,13,26,57,152,95
PI548421,2020,Gibson-IL,500,2,13,28,57,152,95
PI591526,2020,Gibson-IL,517,2,9,31,62,157,95
PI593256,2020,Gibson-IL,635,2,11,51,62,157,95
PI603201,2020,Gibson-IL,636,2,10,51,69,164,95
PI591561,2020,Gibson-IL,664,2,9,56,57,152,95
PI584441,2020,Gibson-IL,692,3,18,4,62,157,95
PI591515,2020,Gibson-IL,729,3,19,10,62,157,95
PI548253,2020,Gibson-IL,740,3,18,12,62,157,95
PI591509,2020,Gibson-IL,747,3,16,13,62,157,95
PI591507,2020,Gibson-IL,774,3,16,18,62,157,95
PI591536,2020,Gibson-IL,807,3,16,23,66,161,95
PI593258,2020,Gibson-IL,860,3,18,32,57,152,95
PI248402,2020,Gibson-IL,875,3,20,35,67,162,95
PI548231,2020,Gibson-IL,900,3,19,39,55,150,95
PI548518,2020,Gibson-IL,945,3,19,46,57,152,95
PI548222,2020,Gibson-IL,953,3,15,48,67,162,95
PI525454,2020,Gibson-IL,964,3,15,49,72,167,95
PI548253,2020,Gibson-IL,67,1,8,26,60,156,96
PI612594,2020,Gibson-IL,82,1,4,27,56,152,96
PI591519,2020,Gibson-IL,127,1,7,23,60,156,96
PI591521,2020,Gibson-IL,159,1,4,28,64,160,96
PI591516,2020,Gibson-IL,163,1,7,29,64,160,96
PI591539,2020,Gibson-IL,174,1,7,30,61,157,96
PI548541,2020,Gibson-IL,216,1,2,37,69,165,96
PI591492,2020,Gibson-IL,233,1,6,40,60,156,96
PI560206,2020,Gibson-IL,235,1,7,41,62,158,96
PI597382,2020,Gibson-IL,259,1,7,45,61,157,96
PI603915D,2020,Gibson-IL,269,1,6,46,64,160,96
PI567527,2020,Gibson-IL,271,1,7,47,66,162,96
PI556572,2020,Gibson-IL,319,1,7,55,64,160,96
PI556859,2020,Gibson-IL,324,1,2,55,64,160,96
PI548685,2020,Gibson-IL,334,1,4,57,57,153,96
PI437459,2020,Gibson-IL,346,2,12,3,59,155,96
PI548373,2020,Gibson-IL,347,2,11,3,57,153,96
PI633729,2020,Gibson-IL,356,2,13,4,62,158,96
PI591504,2020,Gibson-IL,437,2,10,18,61,157,96
PI555396,2020,Gibson-IL,449,2,10,20,64,160,96
PI437894,2020,Gibson-IL,487,2,12,26,57,153,96
PI547885,2020,Gibson-IL,491,2,11,27,61,157,96
PI591521,2020,Gibson-IL,498,2,11,28,64,160,96
PI578057,2020,Gibson-IL,508,2,9,30,64,160,96
PI603186,2020,Gibson-IL,512,2,13,30,57,153,96
PI209331,2020,Gibson-IL,524,2,13,32,55,151,96
PI547864,2020,Gibson-IL,528,2,10,33,61,157,96
PI533654,2020,Gibson-IL,542,2,8,35,61,157,96
PI548541,2020,Gibson-IL,554,2,8,37,71,167,96
PI424159B,2020,Gibson-IL,555,2,8,38,64,160,96
PI548532,2020,Gibson-IL,560,2,13,38,57,153,96
PI548174,2020,Gibson-IL,563,2,11,39,57,153,96
PI548547,2020,Gibson-IL,568,2,9,40,57,153,96
PI547598,2020,Gibson-IL,574,2,12,41,61,157,96
PI577798,2020,Gibson-IL,588,2,10,43,67,163,96
PI603915D,2020,Gibson-IL,607,2,12,46,64,160,96
PI548613,2020,Gibson-IL,623,2,11,49,55,151,96
PI547657,2020,Gibson-IL,626,2,8,49,61,157,96
PI548222,2020,Gibson-IL,628,2,9,50,57,153,96
PI556889,2020,Gibson-IL,655,2,12,54,71,167,96
PI548679,2020,Gibson-IL,668,2,13,56,68,164,96
PI591513,2020,Gibson-IL,679,3,17,2,61,157,96
PI633729,2020,Gibson-IL,693,3,19,4,62,158,96
PI438357B,2020,Gibson-IL,721,3,18,9,64,160,96
PI547876,2020,Gibson-IL,728,3,18,10,62,158,96
PI591505,2020,Gibson-IL,751,3,17,14,62,158,96
PI597387,2020,Gibson-IL,768,3,19,17,59,155,96
PI548383,2020,Gibson-IL,791,3,20,21,57,153,96
PI548275,2020,Gibson-IL,806,3,17,23,64,160,96
PI189935,2020,Gibson-IL,824,3,18,26,66,162,96
PI189928,2020,Gibson-IL,841,3,18,29,59,155,96
PI591510,2020,Gibson-IL,853,3,18,31,59,155,96
PI189926,2020,Gibson-IL,878,3,17,35,64,160,96
PI548678,2020,Gibson-IL,891,3,16,37,71,167,96
PI371611,2020,Gibson-IL,905,3,15,40,61,157,96
PI603571B,2020,Gibson-IL,908,3,18,40,61,157,96
PI597382,2020,Gibson-IL,925,3,18,43,62,158,96
PI548602,2020,Gibson-IL,943,3,17,46,71,167,96
PI547501,2020,Gibson-IL,950,3,17,47,59,155,96
PI547657,2020,Gibson-IL,951,3,16,47,62,158,96
PI603454,2020,Gibson-IL,959,3,20,49,61,157,96
PI603201,2020,Gibson-IL,961,3,18,49,68,164,96
PI548192,2020,Gibson-IL,970,3,20,50,61,157,96
PI591499,2020,Gibson-IL,971,3,20,51,61,157,96
PI556814,2020,Gibson-IL,979,3,17,52,62,158,96
PI556889,2020,Gibson-IL,981,3,19,52,68,164,96
PI591561,2020,Gibson-IL,988,3,15,53,64,160,96
PI548671,2020,Gibson-IL,991,3,17,54,64,160,96
PI574541,2020,Gibson-IL,100,1,5,18,63,160,97
PI634765,2020,Gibson-IL,130,1,4,23,63,160,97
PI578057,2020,Gibson-IL,170,1,3,30,64,161,97
PI603564B,2020,Gibson-IL,219,1,4,38,64,161,97
PI591495,2020,Gibson-IL,247,1,7,43,63,160,97
PI603564C,2020,Gibson-IL,257,1,6,44,63,160,97
PI556928,2020,Gibson-IL,312,1,2,53,63,160,97
PI556889,2020,Gibson-IL,318,1,7,54,68,165,97
PI548671,2020,Gibson-IL,328,1,5,56,64,161,97
PI576166,2020,Gibson-IL,329,1,6,56,65,162,97
PI556511,2020,Gibson-IL,337,1,2,58,56,153,97
PI547847,2020,Gibson-IL,372,2,10,7,61,158,97
PI547876,2020,Gibson-IL,391,2,12,10,58,155,97
PI612594,2020,Gibson-IL,421,2,9,15,60,157,97
PI591530,2020,Gibson-IL,425,2,10,16,61,158,97
PI547886,2020,Gibson-IL,435,2,8,18,57,154,97
PI634765,2020,Gibson-IL,469,2,9,23,63,160,97
PI189935,2020,Gibson-IL,493,2,9,27,64,161,97
PI636695,2020,Gibson-IL,557,2,10,38,63,160,97
PI518668,2020,Gibson-IL,613,2,9,47,68,165,97
PI548297,2020,Gibson-IL,627,2,8,50,60,157,97
PI591535,2020,Gibson-IL,720,3,19,9,58,155,97
PI591519,2020,Gibson-IL,799,3,17,22,61,158,97
PI578057,2020,Gibson-IL,839,3,20,29,65,162,97
PI574534,2020,Gibson-IL,856,3,15,31,56,153,97
PI606748,2020,Gibson-IL,868,3,15,33,61,158,97
PI540555,2020,Gibson-IL,879,3,16,35,58,155,97
PI615556,2020,Gibson-IL,880,3,15,35,58,155,97
PI548541,2020,Gibson-IL,884,3,18,36,70,167,97
PI548682,2020,Gibson-IL,997,3,18,55,60,157,97
PI547813,2020,Gibson-IL,65,1,7,26,57,155,98
PI597387,2020,Gibson-IL,96,1,2,17,61,159,98
PI591536,2020,Gibson-IL,136,1,5,24,64,162,98
PI614153,2020,Gibson-IL,151,1,7,27,55,153,98
PI591518,2020,Gibson-IL,166,1,4,29,62,160,98
PI567351B,2020,Gibson-IL,168,1,2,29,63,161,98
PI548412,2020,Gibson-IL,181,1,2,32,59,157,98
PI547484,2020,Gibson-IL,207,1,4,36,59,157,98
PI591494,2020,Gibson-IL,214,1,4,37,62,160,98
PI424159B,2020,Gibson-IL,217,1,2,38,62,160,98
PI548598,2020,Gibson-IL,261,1,5,45,65,163,98
PI548193,2020,Gibson-IL,299,1,3,51,68,166,98
PI576160,2020,Gibson-IL,311,1,3,53,59,157,98
PI556780,2020,Gibson-IL,321,1,5,55,63,161,98
PI568245,2020,Gibson-IL,331,1,7,57,59,157,98
PI584441,2020,Gibson-IL,355,2,12,4,62,160,98
PI547813,2020,Gibson-IL,404,2,13,12,64,162,98
PI548253,2020,Gibson-IL,405,2,13,13,59,157,98
PI634762,2020,Gibson-IL,408,2,10,13,57,155,98
PI548365,2020,Gibson-IL,410,2,8,13,62,160,98
PI591505,2020,Gibson-IL,416,2,13,14,62,160,98
PI591537,2020,Gibson-IL,464,2,13,22,59,157,98
PI547860,2020,Gibson-IL,489,2,13,27,59,157,98
PI548204,2020,Gibson-IL,497,2,10,28,57,155,98
PI591538,2020,Gibson-IL,507,2,8,30,59,157,98
PI189928,2020,Gibson-IL,510,2,11,30,57,155,98
PI591539,2020,Gibson-IL,511,2,12,30,57,155,98
PI593258,2020,Gibson-IL,529,2,9,33,57,155,98
PI603564A,2020,Gibson-IL,570,2,11,40,55,153,98
PI547471,2020,Gibson-IL,593,2,10,44,64,162,98
PI518663,2020,Gibson-IL,632,2,13,50,56,154,98
PI547477,2020,Gibson-IL,643,2,12,52,62,160,98
PI556857,2020,Gibson-IL,651,2,8,54,57,155,98
PI568245,2020,Gibson-IL,669,2,13,57,57,155,98
PI437367,2020,Gibson-IL,686,3,17,3,64,162,98
PI591530,2020,Gibson-IL,758,3,17,15,59,157,98
PI547886,2020,Gibson-IL,769,3,18,17,57,155,98
PI634764,2020,Gibson-IL,781,3,18,19,59,157,98
PI209331,2020,Gibson-IL,854,3,17,31,57,155,98
PI548549,2020,Gibson-IL,955,3,17,48,62,160,98
PI593256,2020,Gibson-IL,960,3,19,49,65,163,98
PI560207,2020,Gibson-IL,222,1,7,38,64,163,99
PI606749,2020,Gibson-IL,227,1,3,39,61,160,99
PI538401B,2020,Gibson-IL,228,1,2,39,61,160,99
PI547617,2020,Gibson-IL,267,1,4,46,61,160,99
PI548549,2020,Gibson-IL,290,1,3,50,61,160,99
PI547545,2020,Gibson-IL,291,1,4,50,61,160,99
PI547477,2020,Gibson-IL,305,1,6,52,65,164,99
PI534646,2020,Gibson-IL,309,1,5,53,61,160,99
PI556781,2020,Gibson-IL,327,1,4,56,61,160,99
PI437464,2020,Gibson-IL,365,2,10,6,61,160,99
PI438357B,2020,Gibson-IL,385,2,9,9,63,162,99
PI591515,2020,Gibson-IL,392,2,13,10,61,160,99
PI591518,2020,Gibson-IL,504,2,10,29,59,158,99
PI548546,2020,Gibson-IL,543,2,8,36,63,162,99
PI424405B,2020,Gibson-IL,584,2,13,42,63,162,99
PI543793,2020,Gibson-IL,596,2,13,44,64,163,99
PI548555,2020,Gibson-IL,601,2,9,45,63,162,99
PI515961,2020,Gibson-IL,606,2,11,46,68,167,99
PI595363,2020,Gibson-IL,612,2,10,47,56,155,99
PI534646,2020,Gibson-IL,647,2,11,53,57,156,99
PI437388,2020,Gibson-IL,696,3,19,5,64,163,99
PI555399,2020,Gibson-IL,877,3,18,35,69,168,99
PI591494,2020,Gibson-IL,881,3,15,36,64,163,99
PI560207,2020,Gibson-IL,888,3,19,37,68,167,99
PI424405B,2020,Gibson-IL,912,3,19,41,61,160,99
PI548555,2020,Gibson-IL,929,3,15,44,68,167,99
PI547545,2020,Gibson-IL,956,3,18,48,61,160,99
PI576160,2020,Gibson-IL,975,3,16,51,61,160,99
PI556687,2020,Gibson-IL,985,3,18,53,55,154,99
PI577798,2020,Gibson-IL,249,1,5,43,64,164,100
PI548555,2020,Gibson-IL,264,1,2,45,64,164,100
PI548410,2020,Gibson-IL,265,1,2,46,61,161,100
PI515961,2020,Gibson-IL,268,1,5,46,66,166,100
PI437388,2020,Gibson-IL,359,2,11,5,64,164,100
PI597387,2020,Gibson-IL,434,2,8,17,57,157,100
PI591507,2020,Gibson-IL,440,2,13,18,57,157,100
PI591532,2020,Gibson-IL,484,2,9,26,57,157,100
PI614153,2020,Gibson-IL,490,2,12,27,55,155,100
PI561321,2020,Gibson-IL,532,2,9,34,57,157,100
PI555399,2020,Gibson-IL,547,2,12,36,68,168,100
PI591492,2020,Gibson-IL,571,2,12,40,57,157,100
PI560206,2020,Gibson-IL,573,2,13,41,60,160,100
PI548598,2020,Gibson-IL,599,2,11,45,67,167,100
PI591493,2020,Gibson-IL,608,2,13,46,64,164,100
PI556780,2020,Gibson-IL,659,2,11,55,57,157,100
PI548682,2020,Gibson-IL,672,2,10,57,55,155,100
PI437464,2020,Gibson-IL,703,3,17,6,60,160,100
PI612594,2020,Gibson-IL,755,3,20,15,57,157,100
PI507696C,2020,Gibson-IL,800,3,18,22,61,161,100
PI603193,2020,Gibson-IL,811,3,17,24,57,157,100
PI543793,2020,Gibson-IL,924,3,19,43,62,162,100
PI591497,2020,Gibson-IL,931,3,17,44,57,157,100
PI590932,2020,Gibson-IL,202,1,4,35,64,165,101
PI543793,2020,Gibson-IL,258,1,7,44,60,161,101
PI591561,2020,Gibson-IL,325,1,2,56,62,163,101
PI591536,2020,Gibson-IL,475,2,12,24,61,162,101
PI538401B,2020,Gibson-IL,565,2,9,39,61,162,101
PI591499,2020,Gibson-IL,645,2,13,53,61,162,101
PI556572,2020,Gibson-IL,656,2,13,54,59,160,101
PI574541,2020,Gibson-IL,772,3,15,17,59,160,101
PI591537,2020,Gibson-IL,796,3,15,21,61,162,101
PI547860,2020,Gibson-IL,820,3,15,25,57,158,101
PI591516,2020,Gibson-IL,832,3,15,27,61,162,101
PI591518,2020,Gibson-IL,835,3,17,28,61,162,101
PI590932,2020,Gibson-IL,870,3,16,34,66,167,101
PI424159B,2020,Gibson-IL,885,3,19,36,61,162,101
PI606749,2020,Gibson-IL,893,3,15,38,61,162,101
PI560206,2020,Gibson-IL,901,3,18,39,62,163,101
PI547497,2020,Gibson-IL,944,3,18,46,57,158,101
PI556780,2020,Gibson-IL,984,3,19,53,61,162,101
PI507696C,2020,Gibson-IL,128,1,6,23,58,160,102
PI437711B,2020,Gibson-IL,308,1,6,53,61,163,102
PI548682,2020,Gibson-IL,335,1,3,57,62,164,102
PI371611,2020,Gibson-IL,576,2,10,41,61,163,102
PI597382,2020,Gibson-IL,597,2,13,45,59,161,102
PI642055,2020,Gibson-IL,616,2,9,48,64,166,102
PI547598,2020,Gibson-IL,903,3,16,39,56,158,102
PI515961,2020,Gibson-IL,933,3,19,44,65,167,102
PI548613,2020,Gibson-IL,949,3,18,47,55,157,102
PI518663,2020,Gibson-IL,957,3,19,48,55,157,102
PI633732,2020,Gibson-IL,968,3,18,50,58,160,102
PI606748,2020,Gibson-IL,200,1,6,35,57,160,103
PI606748,2020,Gibson-IL,537,2,13,35,57,160,103
PI560207,2020,Gibson-IL,558,2,11,38,64,167,103
PI606749,2020,Gibson-IL,564,2,10,39,61,164,103
PI432359,2020,Gibson-IL,611,2,11,47,57,160,103
PI547497,2020,Gibson-IL,618,2,11,48,57,160,103
PI432359,2020,Gibson-IL,937,3,18,45,64,167,103
PI547477,2020,Gibson-IL,969,3,19,50,57,160,103
PI591537,2020,Gibson-IL,125,1,6,22,57,161,104
PI636695,2020,Gibson-IL,221,1,6,38,58,162,104
PI633732,2020,Gibson-IL,642,2,11,52,56,160,104
PI548192,2020,Gibson-IL,644,2,13,52,57,161,104
PI591492,2020,Gibson-IL,899,3,20,39,56,160,104
PI548598,2020,Gibson-IL,927,3,16,43,57,161,104
PI548339,2020,Gibson-IL,948,3,19,47,57,161,104
PI534646,2020,Gibson-IL,973,3,18,51,55,160,105
PI556857,2020,Gibson-IL,977,3,15,52,57,162,105
PI507696C,2020,Gibson-IL,467,2,11,23,57,163,106
PI590932,2020,Gibson-IL,539,2,11,35,61,167,106
PI591490,2020,Gibson-IL,569,2,10,40,61,167,106
PI633732,2020,Gibson-IL,304,1,5,52,57,164,107
PI591495,2020,Gibson-IL,585,2,13,43,61,168,107
PI591490,2020,Gibson-IL,897,3,19,38,61,168,107
PI591490,2020,Gibson-IL,231,1,4,40,60,168,108
PI603564C,2020,Gibson-IL,595,2,12,44,58,167,109
PI518668,2020,Gibson-IL,939,3,16,45,56,167,111
PI253661B,2020,ROMNEY-IN,5,1,6,2,50,116,66
PI404173B,2020,ROMNEY-IN,2,1,3,2,54,122,68
PI548204,2020,ROMNEY-IN,233,1,3,19,48,116,68
PI603396,2020,ROMNEY-IN,254,1,8,21,48,116,68
PI636695,2020,ROMNEY-IN,417,2,10,7,54,122,68
PI548191,2020,ROMNEY-IN,620,2,12,22,50,118,68
PI437412,2020,ROMNEY-IN,6,1,7,2,45,114,69
PI438310,2020,ROMNEY-IN,17,1,11,3,49,118,69
PI437377,2020,ROMNEY-IN,331,1,9,27,47,116,69
PI548204,2020,ROMNEY-IN,647,2,13,24,47,116,69
PI437365,2020,ROMNEY-IN,675,2,12,27,47,116,69
PI591509,2020,ROMNEY-IN,98,1,8,9,46,116,70
PI507676,2020,ROMNEY-IN,134,1,5,12,46,116,70
PI438486,2020,ROMNEY-IN,155,1,3,13,46,116,70
PI548558,2020,ROMNEY-IN,568,2,12,18,47,117,70
PI253660A,2020,ROMNEY-IN,569,2,13,18,46,116,70
PI398881,2020,ROMNEY-IN,571,2,12,19,47,117,70
PI547802,2020,ROMNEY-IN,101,1,5,9,47,118,71
PI437357,2020,ROMNEY-IN,265,1,6,22,47,118,71
PI547869,2020,ROMNEY-IN,443,2,10,9,51,122,71
PI548339,2020,ROMNEY-IN,546,2,11,17,54,125,71
PI437550C,2020,ROMNEY-IN,593,2,11,20,45,116,71
PI479740,2020,ROMNEY-IN,72,1,8,7,44,116,72
PI548366,2020,ROMNEY-IN,73,1,7,7,44,116,72
PI189928,2020,ROMNEY-IN,81,1,4,8,44,116,72
PI437903,2020,ROMNEY-IN,124,1,8,11,46,118,72
PI603434,2020,ROMNEY-IN,386,2,12,4,46,118,72
PI479740,2020,ROMNEY-IN,391,2,10,5,46,118,72
PI507692B,2020,ROMNEY-IN,439,2,13,8,46,118,72
PI548366,2020,ROMNEY-IN,440,2,13,9,44,116,72
PI548267,2020,ROMNEY-IN,520,2,11,15,50,122,72
PI548632,2020,ROMNEY-IN,36,1,11,4,45,118,73
PI591540,2020,ROMNEY-IN,84,1,7,8,43,116,73
PI548597,2020,ROMNEY-IN,85,1,8,8,43,116,73
PI437641B,2020,ROMNEY-IN,88,1,11,8,43,116,73
PI548518,2020,ROMNEY-IN,126,1,6,11,43,116,73
PI398881,2020,ROMNEY-IN,143,1,14,12,43,116,73
PI634765,2020,ROMNEY-IN,150,1,8,13,43,116,73
PI547801,2020,ROMNEY-IN,153,1,5,13,49,122,73
PI564718,2020,ROMNEY-IN,157,1,2,14,45,118,73
PI596407,2020,ROMNEY-IN,180,1,4,15,45,118,73
PI438079,2020,ROMNEY-IN,213,1,6,18,49,122,73
PI437103,2020,ROMNEY-IN,545,2,12,17,43,116,73
PI548684,2020,ROMNEY-IN,3,1,4,2,44,118,74
PI595926,2020,ROMNEY-IN,16,1,12,3,43,117,74
PI592946,2020,ROMNEY-IN,30,1,5,4,48,122,74
PI547814,2020,ROMNEY-IN,49,1,5,5,42,116,74
PI586980,2020,ROMNEY-IN,76,1,4,7,42,116,74
PI561330A,2020,ROMNEY-IN,178,1,6,15,42,116,74
PI548686,2020,ROMNEY-IN,209,1,2,18,44,118,74
PI548671,2020,ROMNEY-IN,235,1,2,20,53,127,74
PI548383,2020,ROMNEY-IN,243,1,10,20,48,122,74
PI533654,2020,ROMNEY-IN,326,1,14,27,54,128,74
PI591494,2020,ROMNEY-IN,462,2,10,10,48,122,74
PI548546,2020,ROMNEY-IN,619,2,11,22,48,122,74
PI556989,2020,ROMNEY-IN,674,2,13,27,42,116,74
PI547477,2020,ROMNEY-IN,20,1,8,3,47,122,75
PI547497,2020,ROMNEY-IN,48,1,6,5,47,122,75
PI603564B,2020,ROMNEY-IN,70,1,10,7,50,125,75
PI591499,2020,ROMNEY-IN,79,1,2,8,47,122,75
PI584441,2020,ROMNEY-IN,82,1,5,8,47,122,75
PI547501,2020,ROMNEY-IN,129,1,3,11,41,116,75
PI603442,2020,ROMNEY-IN,136,1,7,12,39,114,75
PI591534,2020,ROMNEY-IN,152,1,6,13,41,116,75
PI591495,2020,ROMNEY-IN,166,1,11,14,53,128,75
PI548373,2020,ROMNEY-IN,189,1,8,16,47,122,75
PI556511,2020,ROMNEY-IN,190,1,9,16,41,116,75
PI437397,2020,ROMNEY-IN,211,1,4,18,47,122,75
PI591494,2020,ROMNEY-IN,234,1,2,19,47,122,75
PI548547,2020,ROMNEY-IN,263,1,4,22,47,122,75
PI548532,2020,ROMNEY-IN,279,1,9,23,47,122,75
PI548304,2020,ROMNEY-IN,290,1,5,24,42,117,75
PI437317,2020,ROMNEY-IN,295,1,10,24,41,116,75
PI507708,2020,ROMNEY-IN,313,1,2,26,43,118,75
PI437461,2020,ROMNEY-IN,488,2,10,12,47,122,75
PI548542,2020,ROMNEY-IN,567,2,11,18,41,116,75
PI548381,2020,ROMNEY-IN,596,2,13,21,41,116,75
PI547813,2020,ROMNEY-IN,673,2,13,26,47,122,75
PI547484,2020,ROMNEY-IN,1,1,2,2,46,122,76
PI603188,2020,ROMNEY-IN,39,1,14,4,46,122,76
PI591493,2020,ROMNEY-IN,45,1,9,5,49,125,76
PI591498,2020,ROMNEY-IN,57,1,6,6,46,122,76
PI437500C,2020,ROMNEY-IN,62,1,11,6,40,116,76
PI602449,2020,ROMNEY-IN,95,1,11,9,46,122,76
PI548685,2020,ROMNEY-IN,99,1,7,9,40,116,76
PI591505,2020,ROMNEY-IN,102,1,4,9,46,122,76
PI561321,2020,ROMNEY-IN,105,1,2,10,40,116,76
PI548562,2020,ROMNEY-IN,107,1,4,10,40,116,76
PI548365,2020,ROMNEY-IN,109,1,6,10,40,116,76
PI547800,2020,ROMNEY-IN,194,1,13,16,46,122,76
PI437463B,2020,ROMNEY-IN,197,1,13,17,46,122,76
PI548194,2020,ROMNEY-IN,238,1,5,20,49,125,76
PI427136,2020,ROMNEY-IN,248,1,14,21,46,122,76
PI518675,2020,ROMNEY-IN,257,1,5,21,40,116,76
PI283331,2020,ROMNEY-IN,260,1,2,21,46,122,76
PI556781,2020,ROMNEY-IN,284,1,4,23,42,118,76
PI612750,2020,ROMNEY-IN,312,1,2,25,40,116,76
PI548194,2020,ROMNEY-IN,365,2,10,3,42,118,76
PI437463B,2020,ROMNEY-IN,467,2,12,11,40,116,76
PI548532,2020,ROMNEY-IN,594,2,12,20,46,122,76
PI576160,2020,ROMNEY-IN,595,2,13,20,41,117,76
PI561330A,2020,ROMNEY-IN,671,2,11,26,40,116,76
PI547617,2020,ROMNEY-IN,9,1,10,2,48,125,77
PI610670,2020,ROMNEY-IN,50,1,4,5,40,117,77
PI591490,2020,ROMNEY-IN,51,1,3,5,51,128,77
PI437365,2020,ROMNEY-IN,53,1,2,6,45,122,77
PI603571B,2020,ROMNEY-IN,59,1,8,6,45,122,77
PI595363,2020,ROMNEY-IN,65,1,14,6,40,117,77
PI556816,2020,ROMNEY-IN,119,1,13,11,45,122,77
PI603205,2020,ROMNEY-IN,128,1,4,11,45,122,77
PI475822B,2020,ROMNEY-IN,160,1,5,14,39,116,77
PI591532,2020,ROMNEY-IN,162,1,7,14,45,122,77
PI438341,2020,ROMNEY-IN,208,1,2,17,39,116,77
PI603442,2020,ROMNEY-IN,361,2,13,2,39,116,77
PI548602,2020,ROMNEY-IN,645,2,11,24,50,127,77
PI548412,2020,ROMNEY-IN,676,2,11,27,41,118,77
PI437461,2020,ROMNEY-IN,15,1,13,3,47,125,78
PI591535,2020,ROMNEY-IN,33,1,8,4,44,122,78
PI547500,2020,ROMNEY-IN,37,1,12,4,44,122,78
PI591531,2020,ROMNEY-IN,43,1,11,5,44,122,78
PI591492,2020,ROMNEY-IN,52,1,2,5,48,126,78
PI548381,2020,ROMNEY-IN,91,1,14,8,44,122,78
PI591512,2020,ROMNEY-IN,106,1,3,10,44,122,78
PI591538,2020,ROMNEY-IN,108,1,5,10,44,122,78
PI437444,2020,ROMNEY-IN,123,1,9,11,44,122,78
PI548250,2020,ROMNEY-IN,127,1,5,11,50,128,78
PI432359,2020,ROMNEY-IN,140,1,11,12,48,126,78
PI567366A,2020,ROMNEY-IN,149,1,9,13,44,122,78
PI548602,2020,ROMNEY-IN,156,1,2,13,49,127,78
PI567404A,2020,ROMNEY-IN,164,1,9,14,44,122,78
PI548174,2020,ROMNEY-IN,183,1,2,16,44,122,78
PI548603,2020,ROMNEY-IN,249,1,13,21,47,125,78
PI548613,2020,ROMNEY-IN,261,1,2,22,40,118,78
PI548635,2020,ROMNEY-IN,291,1,6,24,44,122,78
PI547798,2020,ROMNEY-IN,338,1,2,27,44,122,78
PI547497,2020,ROMNEY-IN,387,2,13,4,47,125,78
PI548684,2020,ROMNEY-IN,438,2,12,8,44,122,78
PI578057,2020,ROMNEY-IN,649,2,12,25,47,125,78
PI518663,2020,ROMNEY-IN,672,2,12,26,40,118,78
PI548275,2020,ROMNEY-IN,10,1,11,2,47,126,79
PI170380,2020,ROMNEY-IN,19,1,9,3,46,125,79
PI593258,2020,ROMNEY-IN,26,1,2,3,43,122,79
PI574532,2020,ROMNEY-IN,38,1,13,4,43,122,79
PI547869,2020,ROMNEY-IN,56,1,5,6,45,124,79
PI437388,2020,ROMNEY-IN,58,1,7,6,47,126,79
PI417526,2020,ROMNEY-IN,71,1,9,7,46,125,79
PI560207,2020,ROMNEY-IN,75,1,5,7,51,130,79
PI548177,2020,ROMNEY-IN,89,1,12,8,46,125,79
PI370055,2020,ROMNEY-IN,114,1,11,10,43,122,79
PI547663,2020,ROMNEY-IN,116,1,13,10,46,125,79
PI548549,2020,ROMNEY-IN,145,1,13,13,47,126,79
PI636464,2020,ROMNEY-IN,151,1,7,13,43,122,79
PI437359,2020,ROMNEY-IN,158,1,3,14,43,122,79
PI591515,2020,ROMNEY-IN,175,1,9,15,43,122,79
PI437467,2020,ROMNEY-IN,181,1,3,15,43,122,79
PI548297,2020,ROMNEY-IN,196,1,14,17,47,126,79
PI552538,2020,ROMNEY-IN,204,1,6,17,43,122,79
PI548558,2020,ROMNEY-IN,214,1,7,18,46,125,79
PI548421,2020,ROMNEY-IN,222,1,14,19,46,125,79
PI437391,2020,ROMNEY-IN,247,1,14,20,43,122,79
PI548525,2020,ROMNEY-IN,258,1,4,21,43,122,79
PI547813,2020,ROMNEY-IN,267,1,8,22,46,125,79
PI547598,2020,ROMNEY-IN,276,1,12,23,47,126,79
PI548546,2020,ROMNEY-IN,298,1,13,24,48,127,79
PI547545,2020,ROMNEY-IN,304,1,10,25,48,127,79
PI578057,2020,ROMNEY-IN,307,1,7,25,47,126,79
PI595754,2020,ROMNEY-IN,390,2,11,5,46,125,79
PI556932,2020,ROMNEY-IN,515,2,11,14,53,132,79
PI404173B,2020,ROMNEY-IN,518,2,13,15,51,130,79
PI547864,2020,ROMNEY-IN,23,1,5,3,42,122,80
PI615555,2020,ROMNEY-IN,25,1,3,3,45,125,80
PI560206,2020,ROMNEY-IN,32,1,7,4,46,126,80
PI590932,2020,ROMNEY-IN,34,1,9,4,50,130,80
PI642055,2020,ROMNEY-IN,47,1,7,5,50,130,80
PI548614,2020,ROMNEY-IN,54,1,3,6,42,122,80
PI437711B,2020,ROMNEY-IN,130,1,2,11,48,128,80
PI547657,2020,ROMNEY-IN,132,1,3,12,46,126,80
PI534647,2020,ROMNEY-IN,146,1,12,13,42,122,80
PI548678,2020,ROMNEY-IN,147,1,11,13,52,132,80
PI603193,2020,ROMNEY-IN,159,1,4,14,42,122,80
PI591518,2020,ROMNEY-IN,161,1,6,14,42,122,80
PI507692B,2020,ROMNEY-IN,168,1,13,14,45,125,80
PI437103,2020,ROMNEY-IN,171,1,13,15,46,126,80
PI475822C,2020,ROMNEY-IN,177,1,7,15,52,132,80
PI542711,2020,ROMNEY-IN,191,1,10,16,42,122,80
PI438252C,2020,ROMNEY-IN,228,1,8,19,42,122,80
PI547811,2020,ROMNEY-IN,256,1,6,21,42,122,80
PI548542,2020,ROMNEY-IN,266,1,7,22,42,122,80
PI548633,2020,ROMNEY-IN,270,1,11,22,46,126,80
PI612932,2020,ROMNEY-IN,272,1,13,22,42,122,80
PI567351B,2020,ROMNEY-IN,275,1,13,23,47,127,80
PI556989,2020,ROMNEY-IN,315,1,4,26,42,122,80
PI437550C,2020,ROMNEY-IN,333,1,7,27,46,126,80
PI602449,2020,ROMNEY-IN,414,2,13,7,47,127,80
PI437388,2020,ROMNEY-IN,519,2,12,15,47,127,80
PI542043,2020,ROMNEY-IN,7,1,8,2,44,125,81
PI548339,2020,ROMNEY-IN,13,1,14,2,47,128,81
PI548367,2020,ROMNEY-IN,29,1,4,4,43,124,81
PI542709,2020,ROMNEY-IN,42,1,12,5,43,124,81
PI593256,2020,ROMNEY-IN,60,1,9,6,44,125,81
PI591497,2020,ROMNEY-IN,67,1,13,7,45,126,81
PI548400,2020,ROMNEY-IN,90,1,13,8,44,125,81
PI548286,2020,ROMNEY-IN,93,1,13,9,45,126,81
PI547885,2020,ROMNEY-IN,96,1,10,9,45,126,81
PI437500B,2020,ROMNEY-IN,122,1,10,11,41,122,81
PI548222,2020,ROMNEY-IN,131,1,2,12,41,122,81
PI189926,2020,ROMNEY-IN,137,1,8,12,44,125,81
PI547847,2020,ROMNEY-IN,139,1,10,12,44,125,81
PI548193,2020,ROMNEY-IN,141,1,12,12,44,125,81
PI437459,2020,ROMNEY-IN,163,1,8,14,44,125,81
PI591504,2020,ROMNEY-IN,179,1,5,15,45,126,81
PI593463,2020,ROMNEY-IN,182,1,2,15,44,125,81
PI567767B,2020,ROMNEY-IN,192,1,11,16,46,127,81
PI525454,2020,ROMNEY-IN,193,1,12,16,46,127,81
PI518663,2020,ROMNEY-IN,201,1,9,17,41,122,81
PI603434,2020,ROMNEY-IN,216,1,9,18,44,125,81
PI548192,2020,ROMNEY-IN,255,1,7,21,46,127,81
PI548652,2020,ROMNEY-IN,262,1,3,22,41,122,81
PI437464,2020,ROMNEY-IN,268,1,9,22,46,127,81
PI438124B,2020,ROMNEY-IN,271,1,12,22,47,128,81
PI438500,2020,ROMNEY-IN,278,1,10,23,41,122,81
PI547879,2020,ROMNEY-IN,282,1,6,23,49,130,81
PI548247,2020,ROMNEY-IN,293,1,8,24,45,126,81
PI538401B,2020,ROMNEY-IN,308,1,6,25,47,128,81
PI556778,2020,ROMNEY-IN,319,1,8,26,44,125,81
PI615556,2020,ROMNEY-IN,332,1,8,27,46,127,81
PI437500C,2020,ROMNEY-IN,349,2,1,2,37,118,81
PI603564C,2020,ROMNEY-IN,516,2,12,14,49,130,81
PI518668,2020,ROMNEY-IN,11,1,12,2,45,127,82
PI534646,2020,ROMNEY-IN,35,1,10,4,44,126,82
PI591503,2020,ROMNEY-IN,55,1,4,6,43,125,82
PI548682,2020,ROMNEY-IN,64,1,13,6,44,126,82
PI424405A,2020,ROMNEY-IN,80,1,3,8,40,122,82
PI612594,2020,ROMNEY-IN,86,1,9,8,43,125,82
PI591510,2020,ROMNEY-IN,92,1,14,9,43,125,82
PI417573,2020,ROMNEY-IN,100,1,6,9,43,125,82
PI548679,2020,ROMNEY-IN,104,1,2,9,49,131,82
PI591539,2020,ROMNEY-IN,112,1,9,10,43,125,82
PI597382,2020,ROMNEY-IN,125,1,7,11,43,125,82
PI634762,2020,ROMNEY-IN,144,1,14,13,43,125,82
PI548180,2020,ROMNEY-IN,167,1,12,14,43,125,82
PI603186,2020,ROMNEY-IN,170,1,14,15,43,125,82
PI518673,2020,ROMNEY-IN,186,1,5,16,43,125,82
PI556928,2020,ROMNEY-IN,187,1,6,16,43,125,82
PI253660A,2020,ROMNEY-IN,195,1,14,16,43,125,82
PI153292,2020,ROMNEY-IN,198,1,12,17,40,122,82
PI556931,2020,ROMNEY-IN,206,1,4,17,40,122,82
PI542044,2020,ROMNEY-IN,207,1,3,17,43,125,82
PI568245,2020,ROMNEY-IN,210,1,3,18,44,126,82
PI189935,2020,ROMNEY-IN,240,1,7,20,47,129,82
PI547655,2020,ROMNEY-IN,251,1,11,21,46,128,82
PI437392,2020,ROMNEY-IN,259,1,3,21,40,122,82
PI437124,2020,ROMNEY-IN,280,1,8,23,43,125,82
PI438357B,2020,ROMNEY-IN,281,1,7,23,46,128,82
PI534645,2020,ROMNEY-IN,289,1,4,24,40,122,82
PI552538,2020,ROMNEY-IN,384,2,10,4,40,122,82
PI634762,2020,ROMNEY-IN,388,2,13,5,48,130,82
PI547876,2020,ROMNEY-IN,436,2,10,8,40,122,82
PI547814,2020,ROMNEY-IN,468,2,11,11,40,122,82
PI591536,2020,ROMNEY-IN,517,2,13,14,47,129,82
PI548613,2020,ROMNEY-IN,541,2,11,16,40,122,82
PI614153,2020,ROMNEY-IN,21,1,7,3,42,125,83
PI556857,2020,ROMNEY-IN,87,1,10,8,45,128,83
PI634764,2020,ROMNEY-IN,94,1,12,9,42,125,83
PI515961,2020,ROMNEY-IN,103,1,3,9,46,129,83
PI593654,2020,ROMNEY-IN,120,1,12,11,42,125,83
PI633729,2020,ROMNEY-IN,138,1,9,12,44,127,83
PI574541,2020,ROMNEY-IN,219,1,12,18,47,130,83
PI614832,2020,ROMNEY-IN,221,1,14,18,42,125,83
PI548340,2020,ROMNEY-IN,227,1,9,19,42,125,83
PI603915D,2020,ROMNEY-IN,244,1,11,20,43,126,83
PI437894,2020,ROMNEY-IN,250,1,12,21,43,126,83
PI548670,2020,ROMNEY-IN,253,1,9,21,43,126,83
PI547886,2020,ROMNEY-IN,303,1,11,25,42,125,83
PI591506,2020,ROMNEY-IN,309,1,5,25,42,125,83
PI591521,2020,ROMNEY-IN,324,1,13,26,46,129,83
PI556932,2020,ROMNEY-IN,335,1,5,27,51,134,83
PI548267,2020,ROMNEY-IN,340,1,3,28,50,133,83
PI603201,2020,ROMNEY-IN,342,1,5,28,47,130,83
PI548541,2020,ROMNEY-IN,489,2,11,12,51,134,83
PI568245,2020,ROMNEY-IN,492,2,13,13,42,125,83
PI591504,2020,ROMNEY-IN,570,2,13,19,42,125,83
PI591509,2020,ROMNEY-IN,623,2,12,23,42,125,83
PI189926,2020,ROMNEY-IN,646,2,12,24,42,125,83
PI603454,2020,ROMNEY-IN,12,1,13,2,43,127,84
PI591517,2020,ROMNEY-IN,28,1,3,4,43,127,84
PI636695,2020,ROMNEY-IN,44,1,10,5,47,131,84
PI548262,2020,ROMNEY-IN,69,1,11,7,43,127,84
PI248402,2020,ROMNEY-IN,115,1,12,10,43,127,84
PI548541,2020,ROMNEY-IN,117,1,14,10,50,134,84
PI556859,2020,ROMNEY-IN,118,1,14,11,43,127,84
PI540555,2020,ROMNEY-IN,184,1,3,16,43,127,84
PI556687,2020,ROMNEY-IN,202,1,8,17,41,125,84
PI636696,2020,ROMNEY-IN,217,1,10,18,51,135,84
PI548242,2020,ROMNEY-IN,245,1,12,20,43,127,84
PI548412,2020,ROMNEY-IN,294,1,9,24,42,126,84
PI547860,2020,ROMNEY-IN,302,1,12,25,43,127,84
PI437422,2020,ROMNEY-IN,327,1,13,27,46,130,84
PI209331,2020,ROMNEY-IN,337,1,3,27,41,125,84
PI548598,2020,ROMNEY-IN,345,1,8,28,49,133,84
PI547545,2020,ROMNEY-IN,410,2,10,6,46,130,84
PI370055,2020,ROMNEY-IN,412,2,12,6,41,125,84
PI591533,2020,ROMNEY-IN,466,2,13,11,41,125,84
PI591492,2020,ROMNEY-IN,495,2,10,13,41,125,84
PI603915D,2020,ROMNEY-IN,598,2,11,21,42,126,84
PI591519,2020,ROMNEY-IN,27,1,2,4,40,125,85
PI634763,2020,ROMNEY-IN,40,1,14,5,43,128,85
PI576160,2020,ROMNEY-IN,246,1,13,20,43,128,85
PI371611,2020,ROMNEY-IN,286,1,2,23,42,127,85
PI602450,2020,ROMNEY-IN,310,1,4,25,47,132,85
PI595754,2020,ROMNEY-IN,311,1,3,25,43,128,85
PI556572,2020,ROMNEY-IN,317,1,6,26,43,128,85
PI567767B,2020,ROMNEY-IN,359,2,11,2,44,129,85
PI591510,2020,ROMNEY-IN,360,2,12,2,45,130,85
PI591515,2020,ROMNEY-IN,364,2,11,3,42,127,85
PI547477,2020,ROMNEY-IN,491,2,13,12,42,127,85
PI636464,2020,ROMNEY-IN,543,2,13,16,40,125,85
PI556859,2020,ROMNEY-IN,544,2,13,17,42,127,85
PI547657,2020,ROMNEY-IN,597,2,12,21,41,126,85
PI548555,2020,ROMNEY-IN,14,1,14,3,45,131,86
PI543793,2020,ROMNEY-IN,113,1,10,10,42,128,86
PI591528,2020,ROMNEY-IN,142,1,13,12,39,125,86
PI424405B,2020,ROMNEY-IN,169,1,14,14,42,128,86
PI534648,2020,ROMNEY-IN,176,1,8,15,40,126,86
PI437338,2020,ROMNEY-IN,224,1,12,19,43,129,86
PI603564C,2020,ROMNEY-IN,229,1,7,19,46,132,86
PI591516,2020,ROMNEY-IN,230,1,6,19,42,128,86
PI548585,2020,ROMNEY-IN,231,1,5,19,42,128,86
PI574534,2020,ROMNEY-IN,232,1,4,19,41,127,86
PI567527,2020,ROMNEY-IN,277,1,11,23,47,133,86
PI547471,2020,ROMNEY-IN,329,1,11,27,41,127,86
PI153243,2020,ROMNEY-IN,334,1,6,27,43,129,86
PI591533,2020,ROMNEY-IN,341,1,4,28,41,127,86
PI437391,2020,ROMNEY-IN,415,2,12,7,39,125,86
PI612594,2020,ROMNEY-IN,441,2,12,9,42,128,86
PI591505,2020,ROMNEY-IN,490,2,12,12,42,128,86
PI576166,2020,ROMNEY-IN,542,2,12,16,41,127,86
PI555396,2020,ROMNEY-IN,66,1,14,7,44,131,87
PI548231,2020,ROMNEY-IN,172,1,12,15,40,127,87
PI591526,2020,ROMNEY-IN,199,1,11,17,41,128,87
PI548517,2020,ROMNEY-IN,226,1,10,19,43,130,87
PI591513,2020,ROMNEY-IN,264,1,5,22,43,130,87
PI597387,2020,ROMNEY-IN,288,1,3,24,40,127,87
PI603428D,2020,ROMNEY-IN,296,1,11,24,42,129,87
PI424159B,2020,ROMNEY-IN,299,1,14,24,44,131,87
PI437487,2020,ROMNEY-IN,300,1,14,25,42,129,87
PI437367,2020,ROMNEY-IN,322,1,11,26,43,130,87
PI548191,2020,ROMNEY-IN,323,1,12,26,43,130,87
PI547876,2020,ROMNEY-IN,325,1,14,26,43,130,87
PI591507,2020,ROMNEY-IN,346,1,9,28,43,130,87
PI437459,2020,ROMNEY-IN,493,2,12,13,42,129,87
PI556572,2020,ROMNEY-IN,494,2,11,13,41,128,87
PI424159B,2020,ROMNEY-IN,622,2,13,23,43,130,87
PI603564A,2020,ROMNEY-IN,174,1,10,15,40,128,88
PI634761,2020,ROMNEY-IN,225,1,11,19,41,129,88
PI548410,2020,ROMNEY-IN,269,1,10,22,46,134,88
PI597382,2020,ROMNEY-IN,416,2,11,7,42,130,88
PI633732,2020,ROMNEY-IN,442,2,11,9,40,128,88
PI548555,2020,ROMNEY-IN,464,2,12,10,46,134,88
PI555399,2020,ROMNEY-IN,121,1,11,11,44,133,89
PI591530,2020,ROMNEY-IN,218,1,11,18,42,131,89
PI548636,2020,ROMNEY-IN,220,1,13,18,42,131,89
PI438409,2020,ROMNEY-IN,223,1,13,19,42,131,89
PI556814,2020,ROMNEY-IN,237,1,4,20,42,131,89
PI606748,2020,ROMNEY-IN,273,1,14,22,41,130,89
PI577798,2020,ROMNEY-IN,301,1,13,25,43,132,89
PI614155,2020,ROMNEY-IN,316,1,5,26,41,130,89
PI548253,2020,ROMNEY-IN,318,1,7,26,43,132,89
PI556889,2020,ROMNEY-IN,321,1,10,26,47,136,89
PI538401B,2020,ROMNEY-IN,362,2,13,2,43,132,89
PI591537,2020,ROMNEY-IN,215,1,8,18,42,132,90
PI591561,2020,ROMNEY-IN,236,1,3,20,40,130,90
PI576166,2020,ROMNEY-IN,328,1,12,27,41,131,90
PI614153,2020,ROMNEY-IN,411,2,11,6,40,130,90
PI591503,2020,ROMNEY-IN,413,2,13,6,40,130,90
PI614154,2020,ROMNEY-IN,200,1,10,17,40,131,91
PI548333,2020,ROMNEY-IN,203,1,7,17,39,130,91
PI633732,2020,ROMNEY-IN,287,1,2,24,41,132,91
PI591536,2020,ROMNEY-IN,306,1,8,25,41,132,91
PI614155,2020,ROMNEY-IN,385,2,11,4,42,133,91
PI507696C,2020,ROMNEY-IN,320,1,9,26,42,134,92
PI556780,2020,ROMNEY-IN,343,1,6,28,43,135,92
PI606749,2020,ROMNEY-IN,285,1,3,23,41,135,94
PI543793,2020,ROMNEY-IN,465,2,13,10,39,134,95
PI591513,2020,ROMNEY-IN,514,2,10,14,NA,122,NA
